Player,Pos,Age,G,MP,FG,FGA,FG%,3P,3PA,3P%,2P,2PA,2P%,eFG%,FT,FTA,FT%,ORB,DRB,TRB,AST,STL,BLK,TOV,PF,PTS,Status,Season
Kareem Abdul-Jabbar,C,33,80,2976,836,1457,0.574,0,1,0.0,836,1456,0.574,0.574,423,552,0.766,197,624,821,272,59,228,249,244,2095,Candidate,1981
Tom Abernethy,SF,26,39,298,25,59,0.424,0,1,0.0,25,58,0.431,0.424,13,22,0.591,20,28,48,19,7,3,8,34,63,OOR,1981
Alvan Adams,C,26,75,2054,458,870,0.526,0,0,0.0,458,870,0.526,0.526,199,259,0.768,157,389,546,344,106,69,226,226,1115,OOR,1981
Darrell Allums,PF,22,22,276,23,67,0.343,0,1,0.0,23,66,0.348,0.343,13,22,0.591,19,46,65,25,5,8,23,51,59,OOR,1981
Tiny Archibald,PG,32,80,2820,382,766,0.499,0,9,0.0,382,757,0.505,0.499,342,419,0.816,36,140,176,618,75,18,265,201,1106,OOR,1981
Dennis Awtrey,C,32,47,607,44,93,0.473,0,0,0.0,44,93,0.473,0.473,14,20,0.7,33,75,108,54,12,8,33,85,102,OOR,1981
James Bailey,PF,23,82,2539,444,889,0.499,1,2,0.5,443,887,0.499,0.5,256,361,0.709,192,415,607,98,74,143,219,332,1145,OOR,1981
Greg Ballard,SF,26,82,2610,549,1186,0.463,7,32,0.219,542,1154,0.47,0.466,166,196,0.847,167,413,580,195,118,39,117,194,1271,OOR,1981
Mike Bantom,SF,29,76,2375,431,882,0.489,0,6,0.0,431,876,0.492,0.489,199,281,0.708,150,277,427,240,80,85,197,284,1061,OOR,1981
Billy Ray Bates,SG,24,77,1560,439,902,0.487,14,54,0.259,425,848,0.501,0.494,170,199,0.854,71,86,157,196,82,6,149,120,1062,OOR,1981
Mel Bennett,PF,26,28,313,26,60,0.433,0,2,0.0,26,58,0.448,0.433,53,81,0.654,33,60,93,15,3,11,31,56,105,OOR,1981
Kent Benson,C,26,59,1956,364,770,0.473,0,4,0.0,364,766,0.475,0.473,196,254,0.772,124,276,400,172,72,67,190,184,924,OOR,1981
Henry Bibby,PG,31,73,1112,118,306,0.386,32,95,0.337,86,211,0.408,0.438,67,98,0.684,25,49,74,200,47,2,76,85,335,OOR,1981
Larry Bird,PF,24,82,3239,719,1503,0.478,20,74,0.27,699,1429,0.489,0.485,283,328,0.863,191,704,895,451,161,63,289,239,1741,Candidate,1981
Otis Birdsong,SG,25,71,2593,710,1306,0.544,10,35,0.286,700,1271,0.551,0.547,317,455,0.697,119,139,258,233,93,18,173,172,1747,OOR,1981
Norman Black,SG,23,3,28,3,10,0.3,0,0,0.0,3,10,0.3,0.3,2,8,0.25,0,2,2,2,1,0,1,2,8,OOR,1981
Ron Boone,SG,34,52,1146,160,371,0.431,11,39,0.282,149,332,0.449,0.446,75,94,0.798,17,67,84,161,33,8,111,126,406,OOR,1981
Winford Boynes,SG,23,44,757,121,313,0.387,0,0,0.0,121,313,0.387,0.387,45,55,0.818,24,51,75,37,23,16,69,79,287,OOR,1981
Dudley Bradley,SG,23,82,1867,265,559,0.474,2,16,0.125,263,543,0.484,0.476,125,178,0.702,70,123,193,188,186,37,122,236,657,OOR,1981
Mike Bratz,PG,25,80,2595,319,817,0.39,57,169,0.337,262,648,0.404,0.425,107,132,0.811,66,132,198,452,136,17,162,194,802,OOR,1981
Jim Brewer,PF,29,78,1107,101,197,0.513,0,2,0.0,101,195,0.518,0.513,15,40,0.375,127,154,281,55,43,58,48,158,217,OOR,1981
Ron Brewer,SG,25,75,1452,275,631,0.436,1,7,0.143,274,624,0.439,0.437,91,114,0.798,34,52,86,148,61,34,92,95,642,OOR,1981
Junior Bridgeman,SF,27,77,2215,537,1102,0.487,3,21,0.143,534,1081,0.494,0.489,213,241,0.884,78,211,289,234,88,28,150,182,1290,OOR,1981
Allan Bristow,SF,29,82,2001,271,611,0.444,5,18,0.278,266,593,0.449,0.448,166,198,0.838,103,327,430,383,63,3,171,190,713,OOR,1981
Dave Britton,PG,22,2,9,2,3,0.667,0,0,0.0,2,3,0.667,0.667,0,0,0.0,0,2,2,3,1,0,2,2,4,OOR,1981
Michael Brooks,SF,22,82,2479,488,1018,0.479,0,6,0.0,488,1012,0.482,0.479,226,320,0.706,210,232,442,208,99,31,163,234,1202,OOR,1981
Fred Brown,SG,32,78,1986,505,1035,0.488,23,64,0.359,482,971,0.496,0.499,173,208,0.832,53,122,175,233,88,13,131,141,1206,OOR,1981
Lewis Brown,C,25,2,5,0,3,0.0,0,0,0.0,0,3,0.0,0.0,2,5,0.4,1,1,2,0,0,0,1,2,2,OOR,1981
Rickey Brown,C,22,45,580,83,162,0.512,0,0,0.0,83,162,0.512,0.512,16,21,0.762,52,114,166,21,9,14,31,103,182,OOR,1981
Joe Bryant,PF,26,82,2359,379,791,0.479,2,15,0.133,377,776,0.486,0.48,193,244,0.791,146,294,440,189,72,34,176,264,953,OOR,1981
Quinn Buckner,PG,26,82,2384,471,956,0.493,1,6,0.167,470,950,0.495,0.493,149,203,0.734,88,210,298,384,197,3,236,271,1092,OOR,1981
Tom Burleson,C,28,31,363,41,99,0.414,0,0,0.0,41,99,0.414,0.414,20,41,0.488,44,50,94,12,8,19,24,73,102,OOR,1981
Don Buse,SG,30,58,1095,114,287,0.397,19,58,0.328,95,229,0.415,0.43,50,65,0.769,19,65,84,140,74,8,38,61,297,OOR,1981
Marty Byrnes,SF,24,72,1360,216,451,0.479,9,20,0.45,207,431,0.48,0.489,120,157,0.764,74,103,177,113,29,17,61,126,561,OOR,1981
Mack Calvin,PG,33,21,128,13,39,0.333,1,5,0.2,12,34,0.353,0.346,25,35,0.714,2,10,12,28,5,0,17,13,52,OOR,1981
Austin Carr,SG,32,47,657,87,234,0.372,0,7,0.0,87,227,0.383,0.372,34,54,0.63,22,39,61,58,15,2,41,53,208,OOR,1981
Kenny Carr,PF,25,81,2615,469,918,0.511,0,4,0.0,469,914,0.513,0.511,292,409,0.714,260,575,835,192,76,42,231,296,1230,OOR,1981
M.L. Carr,SF,30,41,655,97,216,0.449,1,14,0.071,96,202,0.475,0.451,53,67,0.791,26,57,83,56,30,18,47,74,248,OOR,1981
Joe Barry Carroll,C,22,82,2919,616,1254,0.491,0,2,0.0,616,1252,0.492,0.491,315,440,0.716,274,485,759,117,50,121,243,313,1547,OOR,1981
Butch Carter,SF,22,54,672,114,247,0.462,3,10,0.3,111,237,0.468,0.468,70,95,0.737,34,31,65,52,23,1,50,99,301,OOR,1981
Reggie Carter,SG,23,60,536,59,179,0.33,0,3,0.0,59,176,0.335,0.33,51,69,0.739,30,39,69,76,22,2,38,68,169,OOR,1981
Bill Cartwright,C,23,82,2925,619,1118,0.554,0,1,0.0,619,1117,0.554,0.554,408,518,0.788,161,452,613,111,48,83,200,259,1646,OOR,1981
Harvey Catchings,PF,29,77,1635,134,300,0.447,0,0,0.0,134,300,0.447,0.447,59,92,0.641,154,319,473,99,33,184,105,284,327,OOR,1981
Maurice Cheeks,PG,24,81,2415,310,581,0.534,3,8,0.375,307,573,0.536,0.536,140,178,0.787,67,178,245,560,193,39,174,231,763,OOR,1981
Phil Chenier,SG,30,9,82,11,33,0.333,1,3,0.333,10,30,0.333,0.348,6,6,1.0,1,7,8,7,0,0,4,10,29,OOR,1981
Jim Chones,PF,31,82,2562,378,751,0.503,0,4,0.0,378,747,0.506,0.503,126,193,0.653,180,477,657,153,39,96,159,324,882,OOR,1981
Art Collins,SG,26,29,395,35,99,0.354,0,2,0.0,35,97,0.361,0.354,24,36,0.667,19,22,41,25,11,1,32,35,94,OOR,1981
Don Collins,SF,22,81,1845,360,811,0.444,0,6,0.0,360,805,0.447,0.444,211,272,0.776,129,139,268,190,104,25,174,259,931,OOR,1981
Doug Collins,SG,29,12,329,62,126,0.492,0,0,0.0,62,126,0.492,0.492,24,29,0.828,6,23,29,42,7,4,22,23,148,OOR,1981
Darwin Cook,SG,22,81,1980,383,819,0.468,6,25,0.24,377,794,0.475,0.471,132,180,0.733,96,140,236,297,141,36,176,197,904,OOR,1981
Jeff Cook,SF,24,79,2192,286,616,0.464,0,5,0.0,286,611,0.468,0.464,100,155,0.645,170,297,467,201,82,54,146,236,672,OOR,1981
Michael Cooper,SG,24,81,2625,321,654,0.491,4,19,0.211,317,635,0.499,0.494,117,149,0.785,121,215,336,332,133,78,164,249,763,OOR,1981
Wayne Cooper,C,24,71,1420,213,471,0.452,1,3,0.333,212,468,0.453,0.453,62,90,0.689,166,274,440,52,18,51,77,219,489,OOR,1981
Dave Corzine,C,24,82,1960,366,747,0.49,0,3,0.0,366,744,0.492,0.49,125,175,0.714,228,408,636,117,42,99,131,212,857,OOR,1981
Charlie Criss,PG,32,66,1708,220,485,0.454,1,21,0.048,219,464,0.472,0.455,185,214,0.864,26,74,100,283,61,3,134,87,626,OOR,1981
Geoff Crompton,C,25,6,33,4,8,0.5,0,0,0.0,4,8,0.5,0.5,1,5,0.2,7,11,18,2,0,2,5,4,9,OOR,1981
Pat Cummings,C,24,74,1084,248,460,0.539,0,2,0.0,248,458,0.541,0.539,99,140,0.707,97,195,292,62,31,19,114,192,595,OOR,1981
Earl Cureton,C,23,52,528,93,205,0.454,0,1,0.0,93,204,0.456,0.454,33,64,0.516,51,104,155,25,20,23,29,68,219,OOR,1981
Bob Dandridge,SF,33,23,545,101,237,0.426,0,1,0.0,101,236,0.428,0.426,28,39,0.718,19,64,83,60,16,9,33,54,230,OOR,1981
Adrian Dantley,SF,25,80,3417,909,1627,0.559,2,7,0.286,907,1620,0.56,0.559,632,784,0.806,192,317,509,322,109,18,282,245,2452,OOR,1981
Brad Davis,PG,25,56,1686,230,410,0.561,3,17,0.176,227,393,0.578,0.565,163,204,0.799,29,122,151,385,52,11,123,156,626,OOR,1981
Johnny Davis,PG,25,76,2536,426,917,0.465,4,33,0.121,422,884,0.477,0.467,238,299,0.796,56,114,170,480,95,14,167,179,1094,OOR,1981
Monti Davis,PF,22,2,10,1,5,0.2,0,0,0.0,1,5,0.2,0.2,1,5,0.2,2,2,4,0,0,1,0,0,3,OOR,1981
Ron Davis,SF,26,64,817,139,314,0.443,2,8,0.25,137,306,0.448,0.446,94,158,0.595,47,72,119,47,36,11,61,98,374,OOR,1981
Walter Davis,SG,26,78,2182,593,1101,0.539,7,17,0.412,586,1084,0.541,0.542,209,250,0.836,63,137,200,302,97,12,222,192,1402,OOR,1981
Darryl Dawkins,C,24,76,2088,423,697,0.607,0,0,0.0,423,697,0.607,0.607,219,304,0.72,106,439,545,109,38,112,220,316,1065,OOR,1981
Larry Demic,PF,23,76,964,128,254,0.504,0,2,0.0,128,252,0.508,0.504,58,92,0.63,114,129,243,28,12,13,58,153,314,OOR,1981
Coby Dietrick,C,32,82,1243,146,320,0.456,2,6,0.333,144,314,0.459,0.459,77,111,0.694,79,186,265,118,48,53,88,176,371,OOR,1981
James Donaldson,C,23,68,980,129,238,0.542,0,0,0.0,129,238,0.542,0.542,101,170,0.594,107,202,309,42,8,74,68,79,359,OOR,1981
Jacky Dorsey,SF,26,29,253,20,70,0.286,0,0,0.0,20,70,0.286,0.286,13,25,0.52,23,65,88,9,9,1,14,47,53,OOR,1981
Leon Douglas,C,26,79,1356,185,323,0.573,0,3,0.0,185,320,0.578,0.573,102,186,0.548,150,234,384,69,25,38,90,251,472,OOR,1981
John Drew,SF,26,67,2075,500,1096,0.456,0,7,0.0,500,1089,0.459,0.456,454,577,0.787,145,238,383,79,98,15,194,264,1454,OOR,1981
Larry Drew,PG,22,76,1581,197,484,0.407,4,17,0.235,193,467,0.413,0.411,106,133,0.797,24,96,120,249,88,7,166,125,504,OOR,1981
Ralph Drollinger,C,26,6,67,7,14,0.5,0,0,0.0,7,14,0.5,0.5,1,4,0.25,5,14,19,14,1,2,13,16,15,OOR,1981
Terry Duerod,SG-SF,24,50,451,104,234,0.444,8,16,0.5,96,218,0.44,0.462,31,41,0.756,17,27,44,36,17,4,35,27,247,OOR,1981
Mike Dunleavy,SG,26,74,1609,310,632,0.491,1,16,0.063,309,616,0.502,0.491,156,186,0.839,28,90,118,268,64,2,137,165,777,OOR,1981
T.R. Dunn,SG,25,82,1427,146,354,0.412,0,2,0.0,146,352,0.415,0.412,79,121,0.653,133,168,301,81,66,29,56,141,371,OOR,1981
John Duren,PG,22,40,458,33,101,0.327,0,1,0.0,33,100,0.33,0.327,5,9,0.556,8,27,35,54,18,2,37,54,71,OOR,1981
James Edwards,C,25,81,2375,511,1004,0.509,0,3,0.0,511,1001,0.51,0.509,244,347,0.703,191,380,571,212,32,128,164,304,1266,OOR,1981
Bob Elliott,C,25,73,1320,214,419,0.511,1,2,0.5,213,417,0.511,0.512,121,202,0.599,104,157,261,129,34,16,119,175,550,OOR,1981
Len Elmore,C,28,72,925,76,212,0.358,0,0,0.0,76,212,0.358,0.358,54,75,0.72,68,140,208,69,37,52,44,178,206,OOR,1981
Alex English,SF,27,81,3093,768,1555,0.494,3,5,0.6,765,1550,0.494,0.495,390,459,0.85,273,373,646,290,106,100,241,255,1929,OOR,1981
Julius Erving,SF,30,82,2874,794,1524,0.521,4,18,0.222,790,1506,0.525,0.522,422,536,0.787,244,413,657,364,173,147,266,233,2014,MVP,1981
Mike Evans,PG,25,71,911,134,291,0.46,2,14,0.143,132,277,0.477,0.464,50,64,0.781,22,65,87,167,34,4,72,114,320,OOR,1981
Eric Fernsten,C,27,45,279,38,79,0.481,0,0,0.0,38,79,0.481,0.481,20,30,0.667,29,33,62,10,6,7,20,29,96,OOR,1981
Chris Ford,SG,32,82,2723,314,707,0.444,36,109,0.33,278,598,0.465,0.47,64,87,0.736,72,91,163,295,100,23,127,212,728,OOR,1981
Don Ford,SF,28,64,996,100,224,0.446,0,3,0.0,100,221,0.452,0.446,22,24,0.917,74,90,164,84,15,12,49,100,222,OOR,1981
Phil Ford,PG,24,66,2287,424,887,0.478,11,36,0.306,413,851,0.485,0.484,294,354,0.831,26,102,128,580,99,6,241,190,1153,OOR,1981
World B. Free,SG,27,65,2370,516,1157,0.446,5,31,0.161,511,1126,0.454,0.448,528,649,0.814,48,111,159,361,85,11,195,183,1565,OOR,1981
Tony Fuller,SG,22,15,248,24,66,0.364,0,1,0.0,24,65,0.369,0.364,12,16,0.75,13,29,42,28,10,1,23,25,60,OOR,1981
Mike Gale,PG,30,77,1112,157,309,0.508,2,7,0.286,155,302,0.513,0.511,55,68,0.809,16,83,99,169,94,7,77,117,371,OOR,1981
Calvin Garrett,SF,24,70,1638,188,415,0.453,1,3,0.333,187,412,0.454,0.454,50,62,0.806,85,179,264,132,50,10,90,167,427,OOR,1981
Gus Gerard,SF,27,27,252,41,111,0.369,0,4,0.0,41,107,0.383,0.369,27,40,0.675,30,37,67,15,10,9,15,41,109,OOR,1981
George Gervin,SG,28,82,2765,850,1729,0.492,9,35,0.257,841,1694,0.496,0.494,512,620,0.826,126,293,419,260,94,56,251,212,2221,Candidate,1981
Artis Gilmore,C,31,82,2832,547,816,0.67,0,0,0.0,547,816,0.67,0.67,375,532,0.705,220,608,828,172,47,198,236,295,1469,OOR,1981
Mike Glenn,PG,25,82,1506,285,511,0.558,4,11,0.364,281,500,0.562,0.562,98,110,0.891,27,61,88,108,72,5,62,126,672,OOR,1981
Mike Gminski,C,21,56,1579,291,688,0.423,0,1,0.0,291,687,0.424,0.423,155,202,0.767,137,282,419,72,54,100,128,127,737,OOR,1981
Glen Gondrezick,PF,25,73,1077,155,329,0.471,0,2,0.0,155,327,0.474,0.471,112,137,0.818,136,171,307,83,91,20,69,185,422,OOR,1981
Rickey Green,PG,26,47,1307,176,366,0.481,0,1,0.0,176,365,0.482,0.481,70,97,0.722,30,86,116,235,75,1,83,123,422,OOR,1981
Dave Greenwood,PF,23,82,2710,481,989,0.486,0,2,0.0,481,987,0.487,0.486,217,290,0.748,243,481,724,218,77,124,192,282,1179,OOR,1981
Kevin Grevey,SG,27,75,2616,500,1103,0.453,45,136,0.331,455,967,0.471,0.474,244,290,0.841,67,152,219,300,68,17,144,161,1289,OOR,1981
Paul Griffin,PF,27,82,1930,166,325,0.511,0,0,0.0,166,325,0.511,0.511,170,253,0.672,184,321,505,249,77,38,132,207,502,OOR,1981
Darrell Griffith,SG,22,81,2867,716,1544,0.464,10,52,0.192,706,1492,0.473,0.467,229,320,0.716,79,209,288,194,106,40,231,219,1671,OOR,1981
Bob Gross,SF,27,82,1934,253,479,0.528,0,9,0.0,253,470,0.538,0.528,135,159,0.849,126,202,328,251,90,67,151,238,641,OOR,1981
Ernie Grunfeld,SF,25,79,1584,260,486,0.535,0,0,0.0,260,486,0.535,0.535,75,101,0.743,31,175,206,205,60,15,88,155,595,OOR,1981
Roy Hamilton,PG,23,1,5,1,3,0.333,0,0,0.0,1,3,0.333,0.333,1,2,0.5,2,1,3,0,0,0,1,1,3,OOR,1981
Bill Hanzlik,SF,23,74,1259,138,289,0.478,1,5,0.2,137,284,0.482,0.479,119,150,0.793,67,86,153,111,58,20,84,168,396,OOR,1981
Alan Hardy,SG,23,22,111,22,59,0.373,0,0,0.0,22,59,0.373,0.373,7,10,0.7,8,11,19,3,1,9,11,13,51,OOR,1981
James Hardy,PF,24,23,509,52,111,0.468,0,0,0.0,52,111,0.468,0.468,11,20,0.55,39,94,133,36,21,20,23,58,115,OOR,1981
Mike Harper,PF,23,55,461,56,136,0.412,0,3,0.0,56,133,0.421,0.412,37,85,0.435,28,65,93,17,23,20,32,73,149,OOR,1981
Joe Hassett,SG,25,41,714,143,340,0.421,53,156,0.34,90,184,0.489,0.499,17,21,0.81,24,44,68,74,13,2,22,65,356,OOR,1981
Steve Hawes,C,30,74,2309,333,637,0.523,1,4,0.25,332,633,0.524,0.524,222,278,0.799,165,396,561,168,73,32,161,289,889,OOR,1981
Elvin Hayes,PF,35,81,2931,584,1296,0.451,0,10,0.0,584,1286,0.454,0.451,271,439,0.617,235,554,789,98,68,171,189,300,1439,OOR,1981
Gar Heard,PF,32,78,1631,149,396,0.376,0,7,0.0,149,389,0.383,0.376,79,101,0.782,120,228,348,122,104,72,81,196,377,OOR,1981
Gerald Henderson,PG,25,82,1608,261,579,0.451,1,16,0.063,260,563,0.462,0.452,113,157,0.72,43,89,132,213,79,12,160,177,636,OOR,1981
Tom Henderson,SG,29,66,1411,137,332,0.413,0,3,0.0,137,329,0.416,0.413,78,95,0.821,30,74,104,307,53,4,93,111,352,OOR,1981
Keith Herron,SG,24,80,2270,432,954,0.453,2,11,0.182,430,943,0.456,0.454,228,267,0.854,98,113,211,148,91,26,153,154,1094,OOR,1981
Kenny Higgs,PG,26,72,1689,209,474,0.441,4,34,0.118,205,440,0.466,0.445,140,172,0.814,24,121,145,408,101,6,166,243,562,OOR,1981
Johnny High,PG,23,81,1750,246,576,0.427,2,24,0.083,244,552,0.442,0.429,183,264,0.693,89,139,228,202,129,26,188,251,677,OOR,1981
Armond Hill,PG,27,75,1738,117,335,0.349,0,7,0.0,117,328,0.357,0.349,141,172,0.82,41,118,159,292,66,11,127,207,375,OOR,1981
Brad Holland,SG,24,41,295,47,111,0.423,1,3,0.333,46,108,0.426,0.428,35,49,0.714,9,20,29,23,21,1,31,44,130,OOR,1981
Lionel Hollins,PG,27,82,2154,327,696,0.47,2,15,0.133,325,681,0.477,0.471,125,171,0.731,47,144,191,352,104,18,207,205,781,OOR,1981
Cedrick Hordges,PF,24,68,1599,221,480,0.46,0,3,0.0,221,477,0.463,0.46,130,186,0.699,120,338,458,104,33,19,120,226,572,OOR,1981
Phil Hubbard,PF,24,80,2289,433,880,0.492,1,3,0.333,432,877,0.493,0.493,294,426,0.69,236,350,586,150,80,20,229,317,1161,OOR,1981
Kim Hughes,C,28,53,490,27,70,0.386,0,0,0.0,27,70,0.386,0.386,1,2,0.5,48,79,127,35,28,35,44,106,55,OOR,1981
Geoff Huston,PG,23,81,2434,461,942,0.489,1,5,0.2,460,937,0.491,0.49,150,212,0.708,45,93,138,394,58,7,179,148,1073,OOR,1981
Dan Issel,C,32,80,2641,614,1220,0.503,2,12,0.167,612,1208,0.507,0.504,519,684,0.759,229,447,676,158,83,53,130,249,1749,OOR,1981
Tony Jackson,PG,23,2,14,1,3,0.333,0,0,0.0,1,3,0.333,0.333,0,0,0.0,0,2,2,2,2,0,0,1,2,OOR,1981
Abdul Jeelani,SF,26,66,1108,187,440,0.425,0,1,0.0,187,439,0.426,0.425,179,220,0.814,83,147,230,65,44,31,87,123,553,OOR,1981
Clemon Johnson,C,24,81,1643,235,466,0.504,0,1,0.0,235,465,0.505,0.504,112,189,0.593,173,295,468,144,44,119,121,185,582,OOR,1981
Dennis Johnson,PG,26,79,2615,532,1220,0.436,11,51,0.216,521,1169,0.446,0.441,411,501,0.82,160,203,363,291,136,61,208,244,1486,OOR,1981
Eddie Johnson,SG,25,75,2693,573,1136,0.504,6,20,0.3,567,1116,0.508,0.507,279,356,0.784,60,119,179,407,126,11,197,188,1431,OOR,1981
George Johnson,C,32,82,1935,164,347,0.473,0,0,0.0,164,347,0.473,0.473,80,109,0.734,215,387,602,92,47,278,110,273,408,OOR,1981
George Johnson,PF,24,43,930,182,394,0.462,0,5,0.0,182,389,0.468,0.462,93,122,0.762,99,179,278,86,47,23,85,120,457,OOR,1981
John Johnson,SF,33,80,2324,373,866,0.431,0,1,0.0,373,865,0.431,0.431,173,214,0.808,135,227,362,312,57,25,230,202,919,OOR,1981
Lee Johnson,PF,23,12,90,7,25,0.28,0,0,0.0,7,25,0.28,0.28,3,5,0.6,6,16,22,1,0,5,7,18,17,OOR,1981
Magic Johnson,SG,21,37,1371,312,587,0.532,3,17,0.176,309,570,0.542,0.534,171,225,0.76,101,219,320,317,127,27,143,100,798,OOR,1981
Marques Johnson,SF,24,76,2542,636,1153,0.552,0,9,0.0,636,1144,0.556,0.552,269,381,0.706,225,293,518,346,115,41,190,196,1541,OOR,1981
Mickey Johnson,PF,28,82,2118,379,846,0.448,3,18,0.167,376,828,0.454,0.45,262,332,0.789,183,362,545,286,94,71,230,256,1023,OOR,1981
Ollie Johnson,SF,31,40,372,87,158,0.551,1,6,0.167,86,152,0.566,0.554,27,31,0.871,8,47,55,30,20,2,25,45,202,OOR,1981
Reggie Johnson,PF,23,79,1716,340,682,0.499,0,1,0.0,340,681,0.499,0.499,128,193,0.663,132,226,358,78,45,48,130,283,808,OOR,1981
Vinnie Johnson,PG,24,81,2311,419,785,0.534,1,5,0.2,418,780,0.536,0.534,214,270,0.793,193,173,366,341,78,20,216,198,1053,OOR,1981
Bobby Jones,PF,29,81,2046,407,755,0.539,0,3,0.0,407,752,0.541,0.539,282,347,0.813,142,293,435,226,95,74,149,226,1096,OOR,1981
Caldwell Jones,C,30,81,2639,218,485,0.449,0,0,0.0,218,485,0.449,0.449,148,193,0.767,200,613,813,122,53,134,168,271,584,OOR,1981
Dwight Jones,PF,28,81,1574,245,507,0.483,0,0,0.0,245,507,0.483,0.483,125,161,0.776,127,274,401,99,40,36,126,200,615,OOR,1981
Edgar Jones,PF,24,60,950,189,357,0.529,0,4,0.0,189,353,0.535,0.529,146,218,0.67,92,171,263,43,36,81,101,185,524,OOR,1981
Major Jones,PF,27,68,1003,117,252,0.464,0,1,0.0,117,251,0.466,0.464,64,101,0.634,96,138,234,41,18,23,57,112,298,OOR,1981
Eddie Jordan,PG,26,74,1226,150,352,0.426,6,22,0.273,144,330,0.436,0.435,87,127,0.685,30,68,98,241,98,8,143,165,393,OOR,1981
Walter Jordan,SF,24,30,207,29,75,0.387,0,0,0.0,29,75,0.387,0.387,10,17,0.588,23,19,42,11,11,5,17,35,68,OOR,1981
Jeff Judkins,SF,24,62,666,92,216,0.426,9,28,0.321,83,188,0.441,0.447,45,51,0.882,29,64,93,59,16,2,30,84,238,OOR,1981
Clarence Kea,PF,21,16,199,37,81,0.457,0,1,0.0,37,80,0.463,0.457,43,62,0.694,28,39,67,5,6,1,16,44,117,OOR,1981
Rich Kelley,C,27,81,1686,196,387,0.506,0,2,0.0,196,385,0.509,0.506,175,231,0.758,131,310,441,282,79,63,209,210,567,OOR,1981
Greg Kelser,SF,23,25,654,120,285,0.421,0,2,0.0,120,283,0.424,0.421,68,106,0.642,53,67,120,45,34,29,78,89,308,OOR,1981
Larry Kenon,SF,28,77,2161,454,946,0.48,0,0,0.0,454,946,0.48,0.48,180,245,0.735,179,219,398,120,75,18,161,160,1088,OOR,1981
Chad Kinch,SG,22,41,353,52,141,0.369,0,0,0.0,52,141,0.369,0.369,14,18,0.778,7,26,33,45,11,6,30,33,118,OOR,1981
Bernard King,SF,24,81,2914,731,1244,0.588,2,6,0.333,729,1238,0.589,0.588,307,437,0.703,178,373,551,287,72,34,265,304,1771,OOR,1981
Reggie King,PF,23,81,2743,472,867,0.544,0,0,0.0,472,867,0.544,0.544,264,386,0.684,235,551,786,122,102,41,164,227,1208,OOR,1981
Billy Knight,SG,28,82,2385,546,1025,0.533,3,19,0.158,543,1006,0.54,0.534,341,410,0.832,191,219,410,157,84,12,177,155,1436,OOR,1981
Joel Kramer,PF,25,82,1065,136,258,0.527,0,1,0.0,136,257,0.529,0.527,63,91,0.692,77,155,232,88,35,17,67,132,335,OOR,1981
Wayne Kreklow,SG,24,25,100,11,47,0.234,1,4,0.25,10,43,0.233,0.245,7,10,0.7,2,10,12,9,2,1,10,20,30,OOR,1981
Kevin Kunnert,C,29,55,842,101,216,0.468,0,0,0.0,101,216,0.468,0.468,42,54,0.778,98,189,287,67,17,32,50,143,244,OOR,1981
Mitch Kupchak,PF,26,82,1934,392,747,0.525,0,1,0.0,392,746,0.525,0.525,240,340,0.706,198,371,569,62,36,26,161,195,1024,OOR,1981
Sam Lacey,C,32,82,2228,237,536,0.442,1,5,0.2,236,531,0.444,0.443,92,117,0.786,131,453,584,399,95,120,182,302,567,OOR,1981
Tom LaGarde,C,25,82,2670,417,888,0.47,0,0,0.0,417,888,0.47,0.47,288,444,0.649,177,488,665,237,35,45,206,293,1122,OOR,1981
Bill Laimbeer,C,23,81,2460,337,670,0.503,0,0,0.0,337,670,0.503,0.503,117,153,0.765,266,427,693,216,56,78,132,332,791,OOR,1981
John Lambert,PF,28,46,483,68,165,0.412,0,2,0.0,68,163,0.417,0.412,18,23,0.783,28,65,93,27,12,5,19,76,154,OOR,1981
Mark Landsberger,PF,25,69,1086,164,327,0.502,0,1,0.0,164,326,0.503,0.502,62,116,0.534,152,225,377,27,19,6,65,135,390,OOR,1981
Bob Lanier,C,32,67,1753,376,716,0.525,1,1,1.0,375,715,0.524,0.526,208,277,0.751,128,285,413,179,73,81,139,184,961,OOR,1981
Edmund Lawrence,C,28,3,19,5,8,0.625,0,0,0.0,5,8,0.625,0.625,2,4,0.5,2,2,4,1,1,0,1,6,12,OOR,1981
Allen Leavell,PG,23,79,1686,258,548,0.471,2,17,0.118,256,531,0.482,0.473,124,149,0.832,30,104,134,384,97,15,189,160,642,OOR,1981
Ron Lee,PG,28,82,1829,113,323,0.35,2,13,0.154,111,310,0.358,0.353,113,156,0.724,65,155,220,362,166,29,173,260,341,OOR,1981
Ronnie Lester,PG,22,8,83,10,24,0.417,0,0,0.0,10,24,0.417,0.417,10,11,0.909,3,3,6,7,2,0,9,5,30,OOR,1981
Scott Lloyd,C,28,72,2186,245,547,0.448,0,2,0.0,245,545,0.45,0.448,147,205,0.717,161,293,454,159,34,25,145,269,637,OOR,1981
John Long,SG,24,59,1750,441,957,0.461,2,11,0.182,439,946,0.464,0.462,160,184,0.87,95,102,197,106,95,22,151,164,1044,OOR,1981
John Lucas,PG,27,66,1919,222,506,0.439,4,24,0.167,218,482,0.452,0.443,107,145,0.738,34,120,154,464,83,2,185,140,555,OOR,1981
Maurice Lucas,PF,28,68,2162,404,835,0.484,0,2,0.0,404,833,0.485,0.484,191,254,0.752,153,422,575,173,57,59,176,260,999,OOR,1981
Ollie Mack,SG,23,65,1682,279,606,0.46,0,9,0.0,279,597,0.467,0.46,80,125,0.64,92,138,230,163,56,7,70,117,638,OOR,1981
Kyle Macy,PG,23,82,1469,272,532,0.511,12,51,0.235,260,481,0.541,0.523,107,119,0.899,44,88,132,160,76,5,95,120,663,OOR,1981
Rick Mahorn,PF,22,52,696,111,219,0.507,0,0,0.0,111,219,0.507,0.507,27,40,0.675,67,148,215,25,21,44,38,134,249,OOR,1981
Moses Malone,C,25,80,3245,806,1545,0.522,1,3,0.333,805,1542,0.522,0.522,609,804,0.757,474,706,1180,141,83,150,308,223,2222,Candidate,1981
Wes Matthews,PG,21,79,2266,385,779,0.494,5,21,0.238,380,758,0.501,0.497,202,252,0.802,46,93,139,411,107,17,261,242,977,OOR,1981
Cedric Maxwell,SF,25,81,2730,441,750,0.588,0,1,0.0,441,749,0.589,0.588,352,450,0.782,222,303,525,219,79,68,180,256,1234,OOR,1981
Scott May,SF,26,63,815,165,338,0.488,0,0,0.0,165,338,0.488,0.488,113,149,0.758,62,93,155,63,35,7,71,83,443,OOR,1981
Bill Mayfield,SF,23,7,54,8,18,0.444,0,0,0.0,8,18,0.444,0.444,1,2,0.5,7,2,9,1,0,1,3,8,17,OOR,1981
Bob McAdoo,PF,29,16,321,68,157,0.433,0,1,0.0,68,156,0.436,0.433,29,41,0.707,17,50,67,30,17,13,32,38,165,OOR,1981
Andre McCarter,PG,27,43,448,51,135,0.378,2,8,0.25,49,127,0.386,0.385,18,24,0.75,16,23,39,73,14,0,24,36,122,OOR,1981
Keith McCord,SG,23,2,9,2,4,0.5,0,0,0.0,2,4,0.5,0.5,0,0,0.0,1,1,2,1,0,0,2,0,4,OOR,1981
Jim McElroy,PG,27,54,680,78,202,0.386,1,8,0.125,77,194,0.397,0.389,48,59,0.814,10,38,48,84,20,9,79,62,205,OOR,1981
George McGinnis,PF,30,69,1845,348,768,0.453,0,7,0.0,348,761,0.457,0.453,207,385,0.538,164,364,528,210,99,28,221,242,903,OOR,1981
Kevin McHale,PF,23,82,1645,355,666,0.533,0,2,0.0,355,664,0.535,0.533,108,159,0.679,155,204,359,55,27,151,110,260,818,OOR,1981
Billy McKinney,PG,25,84,2166,327,645,0.507,2,12,0.167,325,633,0.513,0.509,162,188,0.862,36,148,184,360,99,11,158,231,818,OOR,1981
Tom McMillen,C,28,79,1564,253,519,0.487,1,6,0.167,252,513,0.491,0.488,80,108,0.741,96,199,295,72,23,25,81,165,587,OOR,1981
John Mengelt,SG,31,2,11,0,4,0.0,0,0,0.0,0,4,0.0,0.0,0,0,0.0,0,0,0,2,0,0,0,0,0,OOR,1981
Joe Meriweather,C,27,74,1514,206,415,0.496,0,0,0.0,206,415,0.496,0.496,148,213,0.695,126,267,393,77,27,80,125,219,560,OOR,1981
Dick Miller,SF,22,8,53,4,9,0.444,0,1,0.0,4,8,0.5,0.444,0,0,0.0,2,5,7,5,4,0,8,5,8,OOR,1981
Mike Mitchell,SF,25,82,3194,853,1791,0.476,4,9,0.444,849,1782,0.476,0.477,302,385,0.784,215,287,502,139,63,52,175,199,2012,OOR,1981
Steve Mix,SF,33,72,1327,288,575,0.501,0,3,0.0,288,572,0.503,0.501,200,240,0.833,105,159,264,114,59,18,88,107,776,OOR,1981
Paul Mokeski,C,24,80,1815,224,458,0.489,0,1,0.0,224,457,0.49,0.489,120,200,0.6,141,277,418,135,38,73,160,267,568,OOR,1981
Sidney Moncrief,SG,23,80,2417,400,739,0.541,2,9,0.222,398,730,0.545,0.543,320,398,0.804,186,220,406,264,90,37,145,156,1122,OOR,1981
Johnny Moore,PG,22,82,1578,249,520,0.479,1,19,0.053,248,501,0.495,0.48,105,172,0.61,58,138,196,373,120,22,154,178,604,OOR,1981
Lowes Moore,PG,23,71,1406,212,478,0.444,4,27,0.148,208,451,0.461,0.448,69,92,0.75,43,125,168,228,61,17,108,179,497,OOR,1981
Calvin Murphy,PG,32,76,2014,528,1074,0.492,4,17,0.235,524,1057,0.496,0.493,206,215,0.958,33,54,87,222,111,6,129,209,1266,OOR,1981
Swen Nater,C,31,82,2809,517,935,0.553,0,0,0.0,517,935,0.553,0.553,244,307,0.795,295,722,1017,199,49,46,211,295,1278,OOR,1981
Calvin Natt,SF,24,74,2111,395,794,0.497,4,8,0.5,391,786,0.497,0.5,200,283,0.707,149,282,431,159,73,18,163,188,994,OOR,1981
Kenny Natt,SG,22,19,149,25,77,0.325,2,8,0.25,23,69,0.333,0.338,7,11,0.636,9,6,15,10,5,1,10,18,59,OOR,1981
Mike Newlin,SG,32,79,2911,632,1272,0.497,10,30,0.333,622,1242,0.501,0.501,414,466,0.888,78,141,219,299,87,9,248,237,1688,OOR,1981
Carl Nicks,PG,22,67,1109,172,359,0.479,0,4,0.0,172,355,0.485,0.479,71,126,0.563,37,73,110,149,60,3,116,141,415,OOR,1981
Mike Niles,SF,25,44,231,48,138,0.348,2,4,0.5,46,134,0.343,0.355,17,37,0.459,26,32,58,15,8,1,25,41,115,OOR,1981
Norm Nixon,PG,25,79,2962,576,1210,0.476,2,12,0.167,574,1198,0.479,0.477,196,252,0.778,64,168,232,696,146,11,285,226,1350,OOR,1981
Mike O'Koren,SF,22,79,2473,365,751,0.486,5,18,0.278,360,733,0.491,0.489,135,212,0.637,179,299,478,252,86,27,146,243,870,OOR,1981
Mark Olberding,SF,24,82,2408,348,685,0.508,1,7,0.143,347,678,0.512,0.509,315,380,0.829,146,325,471,277,75,31,202,307,1012,OOR,1981
Jawann Oldham,C,23,4,21,2,6,0.333,0,0,0.0,2,6,0.333,0.333,0,0,0.0,3,2,5,0,0,2,2,3,4,OOR,1981
Louis Orr,SF,22,82,1787,348,709,0.491,0,6,0.0,348,703,0.495,0.491,163,202,0.807,172,189,361,132,55,25,123,153,859,OOR,1981
Tom Owens,PF,31,79,1843,322,630,0.511,0,4,0.0,322,626,0.514,0.511,191,250,0.764,165,291,456,140,36,47,130,273,835,OOR,1981
Robert Parish,C,27,82,2298,635,1166,0.545,0,1,0.0,635,1165,0.545,0.545,282,397,0.71,245,532,777,144,81,214,191,310,1552,OOR,1981
Sonny Parker,SG,25,73,1317,191,388,0.492,0,0,0.0,191,388,0.492,0.492,94,128,0.734,101,93,194,106,67,13,84,112,476,OOR,1981
Myles Patrick,SF,26,3,9,2,5,0.4,0,0,0.0,2,5,0.4,0.4,1,2,0.5,1,1,2,1,0,0,1,3,5,OOR,1981
Billy Paultz,PF,32,81,1659,262,517,0.507,0,3,0.0,262,514,0.51,0.507,75,153,0.49,111,280,391,105,28,72,89,182,599,OOR,1981
Jim Paxson,SG,23,79,2701,585,1092,0.536,2,30,0.067,583,1062,0.549,0.537,182,248,0.734,74,137,211,299,140,9,131,172,1354,OOR,1981
Sam Pellom,PF,29,77,1472,186,380,0.489,0,1,0.0,186,379,0.491,0.489,81,116,0.698,122,234,356,48,50,92,99,228,453,OOR,1981
Roger Phegley,SG,24,82,2269,474,965,0.491,8,28,0.286,466,937,0.497,0.495,224,267,0.839,90,156,246,184,65,15,165,262,1180,OOR,1981
Stan Pietkiewicz,SG,24,42,461,57,138,0.413,19,48,0.396,38,90,0.422,0.482,11,14,0.786,13,29,42,77,15,2,22,28,144,OOR,1981
Ben Poquette,PF,25,82,2808,324,614,0.528,3,6,0.5,321,608,0.528,0.53,126,162,0.778,160,469,629,161,67,174,122,342,777,OOR,1981
Kevin Porter,PG,30,81,2577,446,859,0.519,3,12,0.25,443,847,0.523,0.521,191,247,0.773,35,89,124,734,110,10,251,257,1086,OOR,1981
Tony Price,SG,24,5,29,2,7,0.286,0,0,0.0,2,7,0.286,0.286,0,0,0.0,0,0,0,3,2,1,2,3,4,OOR,1981
Wally Rank,SF,22,25,153,21,57,0.368,0,0,0.0,21,57,0.368,0.368,13,28,0.464,17,13,30,17,7,1,26,33,55,OOR,1981
Kelvin Ransey,PG,22,80,2431,525,1162,0.452,3,31,0.097,522,1131,0.462,0.453,164,219,0.749,42,153,195,555,88,9,232,201,1217,OOR,1981
Clifford Ray,C,32,66,838,64,152,0.421,0,0,0.0,64,152,0.421,0.421,29,62,0.468,73,144,217,52,24,13,74,194,157,OOR,1981
James Ray,PF,23,18,148,15,49,0.306,0,1,0.0,15,48,0.313,0.306,7,10,0.7,13,24,37,11,4,4,13,31,37,OOR,1981
Billy Reid,SG,23,59,597,84,185,0.454,0,5,0.0,84,180,0.467,0.454,22,39,0.564,27,33,60,71,33,5,78,111,190,OOR,1981
Robert Reid,SF,25,82,2963,536,1113,0.482,0,4,0.0,536,1109,0.483,0.482,229,303,0.756,164,419,583,344,163,66,198,325,1301,OOR,1981
Kevin Restani,SF,29,64,999,192,369,0.52,3,8,0.375,189,361,0.524,0.524,62,88,0.705,71,103,174,81,16,14,68,103,449,OOR,1981
Clint Richardson,SG,24,77,1313,227,464,0.489,0,1,0.0,227,463,0.49,0.489,84,108,0.778,83,93,176,152,36,10,110,102,538,OOR,1981
Micheal Ray Richardson,SG,25,79,3175,523,1116,0.469,23,102,0.225,500,1014,0.493,0.479,224,338,0.663,173,372,545,627,232,35,302,258,1293,OOR,1981
Anthony Roberts,SF,25,26,350,54,144,0.375,0,0,0.0,54,144,0.375,0.375,19,29,0.655,18,50,68,20,11,0,28,52,127,OOR,1981
Rick Robey,C,25,82,1569,298,547,0.545,0,1,0.0,298,546,0.546,0.545,144,251,0.574,132,258,390,126,38,19,141,204,740,OOR,1981
Cliff Robinson,PF,20,63,1822,525,1070,0.491,1,1,1.0,524,1069,0.49,0.491,178,248,0.718,120,361,481,105,58,52,182,216,1229,OOR,1981
Truck Robinson,PF,29,82,3088,647,1280,0.505,0,0,0.0,647,1280,0.505,0.505,249,396,0.629,216,573,789,206,68,38,250,220,1543,OOR,1981
Wayne Robinson,PF,22,81,1592,234,509,0.46,0,6,0.0,234,503,0.465,0.46,175,240,0.729,117,177,294,112,46,24,149,186,643,OOR,1981
Bill Robinzine,PF,28,78,2016,392,826,0.475,1,6,0.167,391,820,0.477,0.475,218,281,0.776,168,365,533,118,75,9,187,275,1003,OOR,1981
Dave Robisch,C,31,84,2116,330,740,0.446,0,0,0.0,330,740,0.446,0.446,200,247,0.81,157,342,499,173,37,34,83,173,860,OOR,1981
John Roche,PG,31,26,611,82,179,0.458,9,27,0.333,73,152,0.48,0.483,58,77,0.753,5,32,37,140,17,8,52,44,231,OOR,1981
Tree Rollins,C,25,40,1044,116,210,0.552,0,1,0.0,116,209,0.555,0.552,46,57,0.807,102,184,286,35,29,117,57,151,278,OOR,1981
Lorenzo Romar,PG,22,53,726,87,211,0.412,2,6,0.333,85,205,0.415,0.417,43,63,0.683,10,46,56,136,27,3,52,64,219,OOR,1981
Dan Roundfield,PF,27,63,2128,426,808,0.527,0,1,0.0,426,807,0.528,0.527,256,355,0.721,231,403,634,161,76,119,178,258,1108,OOR,1981
Campy Russell,SF,29,79,2865,508,1095,0.464,8,26,0.308,500,1069,0.468,0.468,268,343,0.781,109,244,353,257,99,8,212,248,1292,OOR,1981
Frankie Sanders,SF,24,23,186,34,77,0.442,0,0,0.0,34,77,0.442,0.442,20,22,0.909,6,15,21,17,16,1,21,20,88,OOR,1981
DeWayne Scales,PF,22,44,484,94,225,0.418,1,6,0.167,93,219,0.425,0.42,26,39,0.667,47,85,132,10,12,4,30,54,215,OOR,1981
Alvin Scott,SF,25,82,1423,173,348,0.497,1,6,0.167,172,342,0.503,0.499,97,127,0.764,101,167,268,114,60,70,77,124,444,OOR,1981
Craig Shelton,SF,23,55,586,100,219,0.457,0,1,0.0,100,218,0.459,0.457,35,58,0.603,59,79,138,27,18,5,61,128,235,OOR,1981
Lonnie Shelton,PF,25,14,440,73,174,0.42,0,0,0.0,73,174,0.42,0.42,36,55,0.655,31,47,78,35,22,3,41,48,182,OOR,1981
Purvis Short,SF,23,79,2309,549,1157,0.475,3,17,0.176,546,1140,0.479,0.476,168,205,0.82,151,240,391,249,78,19,143,244,1269,OOR,1981
John Shumate,PF,28,24,527,56,131,0.427,0,0,0.0,56,131,0.427,0.427,55,76,0.724,34,54,88,24,21,9,42,49,167,OOR,1981
Jerry Sichting,PG,24,47,450,34,95,0.358,0,5,0.0,34,90,0.378,0.358,25,32,0.781,11,32,43,70,23,1,28,38,93,OOR,1981
Jack Sikma,C,25,82,2920,595,1311,0.454,0,5,0.0,595,1306,0.456,0.454,340,413,0.823,184,668,852,248,78,93,201,282,1530,OOR,1981
James Silas,PG,31,75,2055,476,997,0.477,0,2,0.0,476,995,0.478,0.477,374,440,0.85,44,187,231,285,51,12,159,129,1326,OOR,1981
Larry Smith,PF,23,82,2578,304,594,0.512,0,0,0.0,304,594,0.512,0.512,177,301,0.588,433,561,994,93,70,63,146,316,785,OOR,1981
Phil Smith,SG,28,76,2378,519,1057,0.491,4,18,0.222,515,1039,0.496,0.493,237,313,0.757,49,107,156,372,84,18,176,231,1279,OOR,1981
Randy Smith,SG,32,82,2199,486,1043,0.466,1,28,0.036,485,1015,0.478,0.466,221,271,0.815,46,147,193,357,113,14,195,132,1194,OOR,1981
Robert Smith,PG,25,1,20,2,5,0.4,0,0,0.0,2,5,0.4,0.4,4,4,1.0,1,2,3,3,0,0,3,6,8,OOR,1981
Ricky Sobers,PG,28,71,1803,355,769,0.462,17,66,0.258,338,703,0.481,0.473,231,247,0.935,46,98,144,284,98,17,206,225,958,OOR,1981
Jim Spanarkel,SF,23,82,2317,404,866,0.467,1,10,0.1,403,856,0.471,0.467,375,423,0.887,142,155,297,232,117,20,172,230,1184,OOR,1981
Rory Sparrow,PG,22,15,212,22,63,0.349,0,0,0.0,22,63,0.349,0.349,12,16,0.75,7,11,18,32,13,3,18,15,56,OOR,1981
John Stroud,SF,23,9,88,11,34,0.324,0,0,0.0,11,34,0.324,0.324,3,4,0.75,7,6,13,9,1,0,4,7,25,OOR,1981
Brian Taylor,PG,29,80,2312,310,591,0.525,44,115,0.383,266,476,0.559,0.562,146,185,0.789,58,93,151,440,118,23,111,212,810,OOR,1981
Carlos Terry,SG,24,26,504,80,160,0.5,0,6,0.0,80,154,0.519,0.5,28,42,0.667,43,73,116,70,27,13,57,68,188,OOR,1981
Reggie Theus,SG,23,82,2820,543,1097,0.495,18,90,0.2,525,1007,0.521,0.503,445,550,0.809,124,163,287,426,122,20,259,258,1549,OOR,1981
David Thompson,SG,26,77,2620,734,1451,0.506,10,39,0.256,724,1412,0.513,0.509,489,615,0.795,107,180,287,231,53,60,250,231,1967,OOR,1981
Mychal Thompson,C,26,79,2790,569,1151,0.494,0,1,0.0,569,1150,0.495,0.494,207,323,0.641,223,463,686,284,62,170,241,260,1345,OOR,1981
Rudy Tomjanovich,PF,32,52,1264,263,563,0.467,12,51,0.235,251,512,0.49,0.478,65,82,0.793,78,130,208,81,19,6,58,121,603,OOR,1981
Andrew Toney,SG,23,75,1768,399,806,0.495,9,29,0.31,390,777,0.502,0.501,161,226,0.712,32,111,143,273,59,10,219,234,968,OOR,1981
Terry Tyler,SF,24,82,2549,476,895,0.532,0,8,0.0,476,887,0.537,0.532,148,250,0.592,198,369,567,136,112,180,163,215,1100,OOR,1981
Wes Unseld,C,34,63,2032,225,429,0.524,2,4,0.5,223,425,0.525,0.527,55,86,0.64,207,466,673,170,52,36,97,171,507,OOR,1981
Ronnie Valentine,SF,23,24,123,37,98,0.378,1,2,0.5,36,96,0.375,0.383,9,19,0.474,10,20,30,7,7,4,16,23,84,OOR,1981
Jan van Breda Kolff,SF,29,78,1426,100,245,0.408,2,8,0.25,98,237,0.414,0.412,98,117,0.838,48,154,202,129,38,50,108,214,300,OOR,1981
Kiki Vandeweghe,SF,22,51,1376,229,537,0.426,0,7,0.0,229,530,0.432,0.426,130,159,0.818,86,184,270,94,29,24,86,116,588,OOR,1981
Brett Vroman,C,25,11,93,10,27,0.37,0,1,0.0,10,26,0.385,0.37,14,19,0.737,7,18,25,9,5,5,9,26,34,OOR,1981
Foots Walker,PG,29,41,1172,72,169,0.426,2,9,0.222,70,160,0.438,0.432,88,111,0.793,22,80,102,253,52,1,85,105,234,OOR,1981
Wally Walker,SF,26,82,1796,290,626,0.463,0,3,0.0,290,623,0.465,0.463,109,169,0.645,105,210,315,122,53,15,115,168,689,OOR,1981
Lloyd Walton,PG,27,61,821,90,218,0.413,0,1,0.0,90,217,0.415,0.413,26,33,0.788,13,35,48,208,32,2,80,45,206,OOR,1981
Kermit Washington,PF,29,73,2120,325,571,0.569,0,1,0.0,325,570,0.57,0.569,181,288,0.628,236,450,686,149,85,86,144,258,831,OOR,1981
Richard Washington,PF,25,80,1812,340,747,0.455,1,2,0.5,339,745,0.455,0.456,119,159,0.748,158,295,453,129,46,61,129,283,800,OOR,1981
Marvin Webster,C,28,82,1708,159,341,0.466,1,4,0.25,158,337,0.469,0.468,104,163,0.638,162,303,465,72,27,97,103,187,423,OOR,1981
Scott Wedman,SF,28,81,2902,685,1437,0.477,25,77,0.325,660,1360,0.485,0.485,140,204,0.686,128,305,433,226,97,46,161,294,1535,OOR,1981
Paul Westphal,SG,30,36,1078,221,500,0.442,6,25,0.24,215,475,0.453,0.448,153,184,0.832,11,57,68,148,46,14,78,70,601,OOR,1981
Jo Jo White,PG,34,13,236,36,82,0.439,0,0,0.0,36,82,0.439,0.439,11,18,0.611,3,18,21,37,11,1,18,21,83,OOR,1981
Rudy White,SG,27,16,208,23,65,0.354,0,1,0.0,23,64,0.359,0.354,15,16,0.938,1,10,11,20,9,1,12,23,61,OOR,1981
Jerome Whitehead,C,24,48,688,83,180,0.461,0,1,0.0,83,179,0.464,0.461,28,56,0.5,58,156,214,26,20,9,56,122,194,OOR,1981
Hawkeye Whitney,SG,23,47,782,149,306,0.487,2,6,0.333,147,300,0.49,0.49,50,65,0.769,29,77,106,68,47,6,48,98,350,OOR,1981
Sidney Wicks,PF,31,49,1083,125,286,0.437,0,1,0.0,125,285,0.439,0.437,76,150,0.507,79,144,223,111,40,40,94,168,326,OOR,1981
Michael Wiley,PF,23,33,271,76,138,0.551,0,2,0.0,76,136,0.559,0.551,36,48,0.75,22,42,64,11,8,6,28,38,188,OOR,1981
Bob Wilkerson,SG,26,80,2238,330,715,0.462,1,10,0.1,329,705,0.467,0.462,137,163,0.84,86,196,282,272,102,23,175,170,798,OOR,1981
Jamaal Wilkes,SF,27,81,3028,786,1495,0.526,1,13,0.077,785,1482,0.53,0.526,254,335,0.758,146,289,435,235,121,29,207,223,1827,OOR,1981
James Wilkes,SF,22,48,540,85,184,0.462,0,1,0.0,85,183,0.464,0.462,29,42,0.69,36,60,96,30,25,12,34,86,199,OOR,1981
Jeff Wilkins,C,25,56,1058,117,260,0.45,0,0,0.0,117,260,0.45,0.45,27,40,0.675,62,212,274,40,32,46,59,169,261,OOR,1981
Freeman Williams,SG,24,82,1976,642,1381,0.465,48,141,0.34,594,1240,0.479,0.482,253,297,0.852,75,54,129,164,91,5,166,157,1585,OOR,1981
Ray Williams,PG,26,79,2742,616,1335,0.461,16,68,0.235,600,1267,0.474,0.467,312,382,0.817,122,199,321,432,185,37,235,270,1560,OOR,1981
Sly Williams,PF,23,67,1976,349,708,0.493,2,8,0.25,347,700,0.496,0.494,185,268,0.69,159,257,416,180,116,18,141,199,885,OOR,1981
John Williamson,SG,29,9,112,18,56,0.321,1,6,0.167,17,50,0.34,0.33,5,6,0.833,0,7,7,17,4,1,12,13,42,OOR,1981
Bill Willoughby,SF,23,55,1145,150,287,0.523,0,0,0.0,150,287,0.523,0.523,49,64,0.766,74,153,227,64,18,31,74,102,349,OOR,1981
Brian Winters,SG,28,69,1771,331,697,0.475,18,51,0.353,313,646,0.485,0.488,119,137,0.869,32,108,140,229,70,10,136,185,799,OOR,1981
Mike Woodson,SG,22,81,949,165,373,0.442,1,5,0.2,164,368,0.446,0.444,49,64,0.766,33,64,97,75,36,12,54,95,380,OOR,1981
Sam Worthen,PG,23,64,945,95,192,0.495,0,4,0.0,95,188,0.505,0.495,45,60,0.75,22,93,115,115,57,6,91,115,235,OOR,1981
Larry Wright,PG,26,45,997,140,303,0.462,2,7,0.286,138,296,0.466,0.465,53,66,0.803,26,62,88,153,42,7,74,114,335,OOR,1981
