Player,Pos,Age,G,MP,FG,FGA,FG%,3P,3PA,3P%,2P,2PA,2P%,eFG%,FT,FTA,FT%,ORB,DRB,TRB,AST,STL,BLK,TOV,PF,PTS,Status
Kareem Abdul-Jabbar,C,34,76,2677,753,1301,0.579,0,3,0.0,753,1298,0.58,0.579,312,442,0.706,172,487,659,225,63,207,230,224,1818,OOR
Alvan Adams,C,27,79,2393,507,1027,0.494,0,1,0.0,507,1026,0.494,0.494,182,233,0.781,138,448,586,356,114,78,196,269,1196,OOR
Mark Aguirre,SF,22,51,1468,381,820,0.465,25,71,0.352,356,749,0.475,0.48,168,247,0.68,89,160,249,164,37,22,135,152,955,OOR
Danny Ainge,SG,22,53,564,79,221,0.357,5,17,0.294,74,204,0.363,0.369,56,65,0.862,25,31,56,87,37,3,53,86,219,OOR
Tiny Archibald,PG,33,68,2167,308,652,0.472,6,16,0.375,302,636,0.475,0.477,236,316,0.747,25,91,116,541,52,3,178,131,858,OOR
Dennis Awtrey,C,33,10,121,5,15,0.333,0,0,0.0,5,15,0.333,0.333,5,9,0.556,7,7,14,8,1,2,6,28,15,OOR
Carl Bailey,C,23,1,7,1,1,1.0,0,0,0.0,1,1,1.0,1.0,0,0,0.0,0,0,0,0,0,0,2,2,2,OOR
James Bailey,PF,24,77,1468,261,505,0.517,0,0,0.0,261,505,0.517,0.517,137,224,0.612,127,264,391,65,42,83,139,270,659,OOR
Greg Ballard,SF,27,79,2946,621,1307,0.475,9,22,0.409,612,1285,0.476,0.479,235,283,0.83,136,497,633,250,137,22,119,204,1486,OOR
Gene Banks,SF,22,80,1700,311,652,0.477,0,8,0.0,311,644,0.483,0.477,145,212,0.684,157,254,411,147,55,17,106,199,767,OOR
Mike Bantom,SF,30,82,2016,334,712,0.469,2,6,0.333,332,706,0.47,0.471,168,267,0.629,174,266,440,114,63,61,149,272,838,OOR
Billy Ray Bates,SG,25,75,1229,327,692,0.473,12,41,0.293,315,651,0.484,0.481,166,211,0.787,53,55,108,111,41,5,93,100,832,OOR
Mel Bennett,PF,27,3,23,2,4,0.5,0,0,0.0,2,4,0.5,0.5,1,6,0.167,1,2,3,0,1,0,4,2,5,OOR
Kent Benson,C,27,75,2467,405,802,0.505,3,11,0.273,402,791,0.508,0.507,127,158,0.804,219,434,653,159,66,98,160,214,940,OOR
Larry Bird,PF,25,77,2923,711,1414,0.503,11,52,0.212,700,1362,0.514,0.507,328,380,0.863,200,637,837,447,143,66,254,244,1761,Candidate
Otis Birdsong,SG,26,37,1025,225,480,0.469,0,10,0.0,225,470,0.479,0.469,74,127,0.583,30,67,97,124,30,5,64,74,524,OOR
Rolando Blackman,SG,22,82,1979,439,855,0.513,1,4,0.25,438,851,0.515,0.514,212,276,0.768,97,157,254,105,46,30,113,122,1091,OOR
Ray Blume,SG,23,49,546,102,222,0.459,4,18,0.222,98,204,0.48,0.468,18,28,0.643,14,27,41,68,23,2,54,57,226,OOR
Alex Bradley,SF,22,39,331,54,103,0.524,0,1,0.0,54,102,0.529,0.524,29,48,0.604,31,34,65,11,12,5,28,37,137,OOR
Charles Bradley,SG,22,51,339,55,122,0.451,0,1,0.0,55,121,0.455,0.451,42,62,0.677,12,26,38,22,14,6,37,61,152,OOR
Dudley Bradley,SG,24,64,937,125,281,0.445,1,4,0.25,124,277,0.448,0.447,74,100,0.74,30,57,87,80,78,10,71,115,325,OOR
Brad Branson,PF,23,10,176,21,52,0.404,0,0,0.0,21,52,0.404,0.404,11,12,0.917,14,19,33,6,5,4,13,17,53,OOR
Mike Bratz,PG,26,81,1616,230,565,0.407,46,138,0.333,184,427,0.431,0.448,119,152,0.783,40,126,166,438,65,11,139,183,625,OOR
Jim Brewer,PF,30,71,966,81,175,0.463,1,6,0.167,80,169,0.473,0.466,7,19,0.368,106,158,264,42,39,46,37,127,170,OOR
Ron Brewer,SG,26,72,2319,569,1194,0.477,8,31,0.258,561,1163,0.482,0.48,211,260,0.812,55,106,161,188,82,30,125,151,1357,OOR
Junior Bridgeman,SF,28,41,924,209,433,0.483,4,9,0.444,205,424,0.483,0.487,89,103,0.864,37,88,125,109,28,3,64,91,511,OOR
Allan Bristow,SF,30,82,2035,218,499,0.437,3,18,0.167,215,481,0.447,0.44,134,164,0.817,119,220,339,448,65,6,165,222,573,OOR
Jim Brogan,SG,23,63,1027,165,364,0.453,9,32,0.281,156,332,0.47,0.466,61,84,0.726,61,59,120,156,49,13,83,123,400,OOR
Michael Brooks,SF,23,82,2750,537,1066,0.504,0,7,0.0,537,1059,0.507,0.504,202,267,0.757,207,417,624,236,113,39,197,285,1276,OOR
Fred Brown,SG,33,82,1785,393,863,0.455,25,77,0.325,368,786,0.468,0.47,111,129,0.86,42,98,140,238,69,4,96,111,922,OOR
Rickey Brown,C,23,82,1260,192,418,0.459,0,0,0.0,192,418,0.459,0.459,86,122,0.705,136,228,364,19,36,29,84,243,470,OOR
Joe Bryant,SF,27,75,1988,341,701,0.486,8,30,0.267,333,671,0.496,0.492,194,247,0.785,79,195,274,189,78,29,183,250,884,OOR
Quinn Buckner,PG,27,70,2156,396,822,0.482,4,15,0.267,392,807,0.486,0.484,110,168,0.655,77,173,250,328,174,3,180,218,906,OOR
Roger Burkman,SG,23,6,30,0,4,0.0,0,1,0.0,0,3,0.0,0.0,5,6,0.833,2,4,6,5,6,2,3,6,5,OOR
David Burns,PG,23,9,87,7,16,0.438,0,0,0.0,7,16,0.438,0.438,9,15,0.6,1,4,5,15,3,0,13,17,23,OOR
Don Buse,PG,31,82,2529,312,685,0.455,73,189,0.386,239,496,0.482,0.509,100,123,0.813,46,177,223,407,164,27,95,176,797,OOR
Kenny Carr,PF,26,74,1926,348,692,0.503,1,10,0.1,347,682,0.509,0.504,198,302,0.656,167,364,531,86,64,22,152,249,895,OOR
M.L. Carr,SF,31,56,1296,184,409,0.45,5,17,0.294,179,392,0.457,0.456,82,116,0.707,56,94,150,128,67,21,63,136,455,OOR
Joe Barry Carroll,C,23,76,2627,527,1016,0.519,0,1,0.0,527,1015,0.519,0.519,235,323,0.728,210,423,633,64,64,127,206,265,1289,OOR
Butch Carter,SG,23,75,1035,188,402,0.468,8,25,0.32,180,377,0.477,0.478,58,70,0.829,30,49,79,60,34,11,54,110,442,OOR
Reggie Carter,SG,24,75,923,119,280,0.425,0,0,0.0,119,280,0.425,0.425,64,80,0.8,35,60,95,130,36,6,78,124,302,OOR
Bill Cartwright,C,24,72,2060,390,694,0.562,0,0,0.0,390,694,0.562,0.562,257,337,0.763,116,305,421,87,48,65,166,208,1037,OOR
Harvey Catchings,PF,30,80,1603,94,224,0.42,0,0,0.0,94,224,0.42,0.42,41,69,0.594,129,227,356,97,42,134,94,237,229,OOR
Bobby Cattage,PF,23,49,337,60,135,0.444,0,2,0.0,60,133,0.451,0.444,30,41,0.732,22,51,73,7,7,0,18,58,150,OOR
Tom Chambers,PF,22,81,2682,554,1056,0.525,0,2,0.0,554,1054,0.526,0.525,284,458,0.62,211,350,561,146,58,46,220,341,1392,OOR
Maurice Cheeks,PG,25,79,2498,352,676,0.521,6,22,0.273,346,654,0.529,0.525,171,220,0.777,51,197,248,667,209,33,184,247,881,OOR
Jim Chones,C,32,59,867,74,171,0.433,0,0,0.0,74,171,0.433,0.433,36,46,0.783,39,146,185,64,15,32,41,114,184,OOR
Don Collins,SG,23,79,1609,334,653,0.511,1,12,0.083,333,641,0.52,0.512,121,169,0.716,101,95,196,148,89,24,135,195,790,OOR
Darwin Cook,PG,23,82,2090,387,803,0.482,7,31,0.226,380,772,0.492,0.486,118,162,0.728,52,103,155,319,146,24,175,196,899,OOR
Jeff Cook,PF,25,76,1298,151,358,0.422,0,2,0.0,151,356,0.424,0.422,89,134,0.664,112,189,301,100,37,23,80,174,391,OOR
Joe Cooper,C,24,1,11,1,2,0.5,0,0,0.0,1,2,0.5,0.5,0,0,0.0,1,1,2,0,0,0,1,2,2,OOR
Michael Cooper,SG,25,76,2197,383,741,0.517,2,17,0.118,381,724,0.526,0.518,139,171,0.813,84,185,269,230,120,61,151,216,907,OOR
Wayne Cooper,C,25,76,1818,281,669,0.42,1,8,0.125,280,661,0.424,0.421,119,160,0.744,200,350,550,115,37,106,88,285,682,OOR
Hollis Copeland,SF,26,18,118,16,38,0.421,0,0,0.0,16,38,0.421,0.421,5,6,0.833,3,2,5,9,4,2,4,19,37,OOR
Dave Corzine,C,25,82,2189,336,648,0.519,1,4,0.25,335,644,0.52,0.519,159,213,0.746,211,418,629,130,33,126,139,235,832,OOR
Charlie Criss,PG,33,55,1392,222,498,0.446,10,29,0.345,212,469,0.452,0.456,141,159,0.887,13,69,82,187,44,6,82,96,595,OOR
Geoff Crompton,C,26,35,203,11,32,0.344,0,0,0.0,11,32,0.344,0.344,6,15,0.4,10,31,41,13,6,12,17,39,28,OOR
Pat Cummings,PF,25,78,1132,219,430,0.509,0,2,0.0,219,428,0.512,0.509,67,91,0.736,61,184,245,99,22,9,108,227,505,OOR
Earl Cureton,PF,24,66,956,149,306,0.487,0,2,0.0,149,304,0.49,0.487,51,94,0.543,90,180,270,32,31,27,44,142,349,OOR
Bob Dandridge,SF,34,11,174,21,55,0.382,0,0,0.0,21,55,0.382,0.382,10,17,0.588,4,13,17,13,5,2,11,25,52,OOR
Adrian Dantley,SF,26,81,3222,904,1586,0.57,1,3,0.333,903,1583,0.57,0.57,648,818,0.792,231,283,514,324,95,14,299,252,2457,OOR
Brad Davis,PG,26,82,2614,397,771,0.515,14,49,0.286,383,722,0.53,0.524,185,230,0.804,35,191,226,509,73,6,159,218,993,OOR
Charles Davis,SF,23,54,575,88,184,0.478,0,2,0.0,88,182,0.484,0.478,30,37,0.811,54,79,133,31,10,13,43,89,206,OOR
Johnny Davis,SG,26,82,2664,538,1153,0.467,5,27,0.185,533,1126,0.473,0.469,315,394,0.799,72,106,178,346,76,11,186,176,1396,OOR
Ron Davis,SF,27,7,67,10,25,0.4,0,0,0.0,10,25,0.4,0.4,3,6,0.5,7,6,13,4,0,0,5,8,23,OOR
Walter Davis,SF,27,55,1182,350,669,0.523,3,16,0.188,347,653,0.531,0.525,91,111,0.82,21,82,103,162,46,3,112,104,794,OOR
Darryl Dawkins,C,25,48,1124,207,367,0.564,0,2,0.0,207,365,0.567,0.564,114,164,0.695,68,237,305,55,19,55,96,193,528,OOR
Larry Demic,PF,24,48,356,39,83,0.47,0,1,0.0,39,82,0.476,0.47,14,39,0.359,29,50,79,14,4,6,26,65,92,OOR
Kenny Dennard,PF,23,30,607,62,121,0.512,0,0,0.0,62,121,0.512,0.512,26,40,0.65,47,86,133,42,35,8,35,81,150,OOR
Coby Dietrick,C,33,74,999,92,200,0.46,0,1,0.0,92,199,0.462,0.46,38,54,0.704,63,125,188,87,49,30,44,131,222,OOR
Mickey Dillard,PG,23,33,221,29,79,0.367,0,4,0.0,29,75,0.387,0.367,15,23,0.652,6,9,15,34,8,2,17,40,73,OOR
James Donaldson,C,24,82,1710,255,419,0.609,0,0,0.0,255,419,0.609,0.609,151,240,0.629,138,352,490,51,27,139,115,186,661,OOR
John Douglas,SG,25,64,1031,181,389,0.465,18,59,0.305,163,330,0.494,0.488,67,102,0.657,27,63,90,146,48,9,92,147,447,OOR
Leon Douglas,C,27,63,1093,70,140,0.5,0,0,0.0,70,140,0.5,0.5,32,80,0.4,111,179,290,35,15,38,55,210,172,OOR
John Drew,SF,27,70,2040,465,957,0.486,4,12,0.333,461,945,0.488,0.488,364,491,0.741,169,206,375,96,64,3,178,250,1298,OOR
Larry Drew,PG,23,81,1973,358,757,0.473,8,27,0.296,350,730,0.479,0.478,150,189,0.794,30,119,149,419,110,1,174,150,874,OOR
Terry Duerod,SG,25,21,146,34,77,0.442,0,1,0.0,34,76,0.447,0.442,4,12,0.333,6,9,15,12,3,1,2,9,72,OOR
Mike Dunleavy,SG,27,70,1315,206,450,0.458,33,86,0.384,173,364,0.475,0.494,75,106,0.708,24,80,104,227,45,3,80,161,520,OOR
T.R. Dunn,SG,26,82,2519,258,504,0.512,0,1,0.0,258,503,0.513,0.512,153,215,0.712,211,348,559,188,135,36,123,210,669,OOR
John Duren,PG,23,79,1056,121,268,0.451,3,11,0.273,118,257,0.459,0.457,27,37,0.73,14,70,84,157,20,4,72,143,272,OOR
Craig Dykema,SF,22,32,103,17,37,0.459,2,4,0.5,15,33,0.455,0.486,7,9,0.778,3,9,12,15,2,0,7,19,43,OOR
Franklin Edwards,PG,22,42,291,65,150,0.433,0,9,0.0,65,141,0.461,0.433,20,27,0.741,10,17,27,45,16,5,24,37,150,OOR
James Edwards,C,26,77,2539,528,1033,0.511,0,4,0.0,528,1029,0.513,0.511,232,339,0.684,189,392,581,123,24,117,162,347,1288,OOR
Len Elmore,C,29,81,2100,300,652,0.46,0,0,0.0,300,652,0.46,0.46,135,170,0.794,167,274,441,100,92,92,136,280,735,OOR
Alex English,SF,28,82,3015,855,1553,0.551,0,8,0.0,855,1545,0.553,0.551,372,443,0.84,210,348,558,433,87,120,261,261,2082,OOR
Julius Erving,SF,31,81,2789,780,1428,0.546,3,11,0.273,777,1417,0.548,0.547,411,539,0.763,220,337,557,319,161,141,214,229,1974,Candidate
Mike Evans,PG,26,22,270,35,86,0.407,0,6,0.0,35,80,0.438,0.407,13,20,0.65,5,17,22,42,13,0,26,36,83,OOR
Eric Fernsten,C,28,43,202,19,49,0.388,0,0,0.0,19,49,0.388,0.388,19,30,0.633,12,30,42,8,5,7,13,23,57,OOR
Chris Ford,SG,33,76,1591,188,450,0.418,20,63,0.317,168,387,0.434,0.44,39,56,0.696,52,56,108,142,42,10,52,143,435,OOR
Don Ford,SF,29,21,201,9,24,0.375,0,1,0.0,9,23,0.391,0.375,5,6,0.833,14,21,35,11,8,0,15,30,23,OOR
Phil Ford,PG,25,72,1952,285,649,0.439,7,32,0.219,278,617,0.451,0.445,136,166,0.819,24,81,105,451,63,1,194,160,713,OOR
World B. Free,SG,28,78,2796,650,1452,0.448,10,56,0.179,640,1396,0.458,0.451,479,647,0.74,118,130,248,419,71,8,208,222,1789,OOR
Mike Gale,PG,31,75,1793,185,373,0.496,0,5,0.0,185,368,0.503,0.496,51,65,0.785,37,152,189,261,121,28,126,173,421,OOR
Calvin Garrett,SF,25,51,858,105,242,0.434,3,10,0.3,102,232,0.44,0.44,17,26,0.654,27,67,94,76,32,6,38,94,230,OOR
George Gervin,SG,29,79,2817,993,1987,0.5,10,36,0.278,983,1951,0.504,0.502,555,642,0.864,138,254,392,187,77,45,210,215,2551,OOR
Artis Gilmore,C,32,82,2796,546,837,0.652,1,1,1.0,545,836,0.652,0.653,424,552,0.768,224,611,835,136,49,220,227,287,1517,OOR
Mike Glenn,SG,26,49,833,158,291,0.543,1,2,0.5,157,289,0.543,0.545,59,67,0.881,5,56,61,87,26,3,27,80,376,OOR
Mike Gminski,C,22,64,740,119,270,0.441,0,0,0.0,119,270,0.441,0.441,97,118,0.822,70,116,186,41,17,48,56,69,335,OOR
Glen Gondrezick,SF,26,80,1699,250,495,0.505,0,3,0.0,250,492,0.508,0.505,160,217,0.737,140,283,423,152,92,36,100,229,660,OOR
Rickey Green,PG,27,81,2822,500,1015,0.493,0,8,0.0,500,1007,0.497,0.493,202,264,0.765,85,158,243,630,185,9,198,183,1202,OOR
Dave Greenwood,PF,24,82,2914,480,1014,0.473,0,3,0.0,480,1011,0.475,0.473,240,291,0.825,192,594,786,262,70,93,180,292,1200,OOR
Kevin Grevey,SG,28,71,2164,376,857,0.439,28,82,0.341,348,775,0.449,0.455,165,193,0.855,57,138,195,149,44,23,96,151,945,OOR
Paul Griffin,PF,28,23,459,32,66,0.485,0,0,0.0,32,66,0.485,0.485,24,37,0.649,29,66,95,54,20,8,40,67,88,OOR
Darrell Griffith,SG,23,80,2597,689,1429,0.482,15,52,0.288,674,1377,0.489,0.487,189,271,0.697,128,177,305,187,95,34,193,213,1582,OOR
Bob Gross,SF,28,59,1377,173,322,0.537,3,6,0.5,170,316,0.538,0.542,78,104,0.75,101,158,259,125,75,41,88,162,427,OOR
Ernie Grunfeld,SG,26,81,1892,420,822,0.511,2,14,0.143,418,808,0.517,0.512,188,229,0.821,55,127,182,276,72,39,148,191,1030,OOR
Pétur Guðmundsson,C,23,68,845,83,166,0.5,1,1,1.0,82,165,0.497,0.503,52,76,0.684,51,135,186,59,13,30,73,163,219,OOR
Glenn Hagan,PG,26,4,25,3,7,0.429,0,0,0.0,3,7,0.429,0.429,1,1,1.0,2,2,4,8,3,0,1,7,7,OOR
Bill Hanzlik,SF,24,81,1974,167,357,0.468,0,4,0.0,167,353,0.473,0.468,138,176,0.784,99,167,266,183,81,30,106,250,472,OOR
Alan Hardy,SG,24,38,310,62,136,0.456,0,5,0.0,62,131,0.473,0.456,18,29,0.621,14,20,34,20,9,4,20,32,142,OOR
James Hardy,SF,25,82,1814,179,369,0.485,0,1,0.0,179,368,0.486,0.485,64,93,0.688,153,317,470,110,58,67,78,192,422,OOR
Mike Harper,PF,24,68,1433,184,370,0.497,0,1,0.0,184,369,0.499,0.497,96,153,0.627,127,212,339,54,55,82,92,229,464,OOR
Joe Hassett,SG,26,68,787,144,382,0.377,71,214,0.332,73,168,0.435,0.47,31,37,0.838,13,40,53,104,30,3,36,94,390,OOR
Steve Hawes,PF,31,49,1317,178,370,0.481,4,10,0.4,174,360,0.483,0.486,96,126,0.762,89,231,320,142,36,34,87,156,456,OOR
Elvin Hayes,PF,36,82,3032,519,1100,0.472,0,5,0.0,519,1095,0.474,0.472,280,422,0.664,267,480,747,144,62,104,208,287,1318,OOR
Steve Hayes,C,26,35,487,54,111,0.486,0,0,0.0,54,111,0.486,0.486,32,53,0.604,39,78,117,28,4,20,19,71,140,OOR
Spencer Haywood,PF,32,76,2086,395,829,0.476,0,3,0.0,395,826,0.478,0.476,219,260,0.842,144,278,422,64,45,68,175,249,1009,OOR
Gerald Henderson,PG,26,82,1844,353,705,0.501,2,12,0.167,351,693,0.506,0.502,125,172,0.727,47,105,152,252,82,11,150,199,833,OOR
Tom Henderson,SG,30,75,1721,183,403,0.454,0,2,0.0,183,401,0.456,0.454,105,150,0.7,33,105,138,306,55,7,105,120,471,OOR
Keith Herron,SG,25,30,269,39,106,0.368,0,1,0.0,39,105,0.371,0.368,7,8,0.875,10,11,21,23,8,2,12,25,85,OOR
Kenny Higgs,PG,27,76,1696,202,468,0.432,4,21,0.19,198,447,0.443,0.436,161,197,0.817,23,121,144,395,72,6,156,263,569,OOR
Armond Hill,PG,28,40,723,53,126,0.421,0,2,0.0,53,124,0.427,0.421,39,55,0.709,12,40,52,106,21,5,66,88,145,OOR
Brad Holland,SG,25,14,194,27,78,0.346,0,3,0.0,27,75,0.36,0.346,3,6,0.5,6,7,13,18,11,1,8,13,57,OOR
Lionel Hollins,PG,28,81,2257,380,797,0.477,2,16,0.125,378,781,0.484,0.478,132,188,0.702,35,152,187,316,103,20,146,198,894,OOR
Cedrick Hordges,PF,25,77,1372,204,414,0.493,3,13,0.231,201,401,0.501,0.496,116,199,0.583,119,276,395,65,26,19,111,230,527,OOR
Phil Hubbard,SF,25,83,1839,326,665,0.49,0,4,0.0,326,661,0.493,0.49,191,280,0.682,187,286,473,91,65,19,161,292,843,OOR
Geoff Huston,PG,24,78,2409,325,672,0.484,3,10,0.3,322,662,0.486,0.486,153,200,0.765,53,97,150,590,70,11,171,169,806,OOR
Dan Issel,C,33,81,2472,651,1236,0.527,4,6,0.667,647,1230,0.526,0.528,546,655,0.834,174,434,608,179,67,55,169,245,1852,OOR
Tracy Jackson,SG,22,49,478,79,172,0.459,0,0,0.0,79,172,0.459,0.459,38,49,0.776,35,28,63,27,14,3,24,48,196,OOR
Clay Johnson,SG,25,7,65,11,20,0.55,0,0,0.0,11,20,0.55,0.55,3,6,0.5,8,4,12,7,3,3,7,13,25,OOR
Clemon Johnson,C,25,79,1979,312,641,0.487,0,0,0.0,312,641,0.487,0.487,123,189,0.651,184,387,571,127,60,112,138,241,747,OOR
Dennis Johnson,SG,27,80,2937,577,1228,0.47,8,42,0.19,569,1186,0.48,0.473,399,495,0.806,142,268,410,369,105,55,233,253,1561,OOR
Eddie Johnson,SG,26,68,2314,455,1011,0.45,7,30,0.233,448,981,0.457,0.454,294,385,0.764,63,128,191,358,102,16,186,188,1211,OOR
Eddie Johnson,SF,22,74,1517,295,643,0.459,1,11,0.091,294,632,0.465,0.46,99,149,0.664,128,194,322,109,50,14,97,210,690,OOR
Frank Johnson,PG,23,79,2027,336,812,0.414,17,79,0.215,319,733,0.435,0.424,153,204,0.75,34,113,147,380,76,7,160,196,842,OOR
George Johnson,C,33,75,1578,91,195,0.467,0,0,0.0,91,195,0.467,0.467,43,64,0.672,152,302,454,79,20,234,92,259,225,OOR
George Johnson,PF,25,59,720,120,291,0.412,0,2,0.0,120,289,0.415,0.412,60,80,0.75,72,145,217,40,36,25,68,147,300,OOR
John Johnson,SF,34,14,187,22,45,0.489,0,0,0.0,22,45,0.489,0.489,15,20,0.75,3,15,18,29,4,3,17,20,59,OOR
Magic Johnson,SG,22,78,2991,556,1036,0.537,6,29,0.207,550,1007,0.546,0.54,329,433,0.76,252,499,751,743,208,34,286,223,1447,OOR
Marques Johnson,SF,25,60,1900,404,760,0.532,0,4,0.0,404,756,0.534,0.532,182,260,0.7,153,211,364,213,59,35,145,142,990,OOR
Mickey Johnson,PF,29,76,1934,372,757,0.491,1,7,0.143,371,750,0.495,0.492,233,291,0.801,133,321,454,215,72,45,191,240,978,OOR
Ollie Johnson,SF,32,26,150,27,54,0.5,1,3,0.333,26,51,0.51,0.509,6,7,0.857,7,15,22,10,13,3,13,28,61,OOR
Reggie Johnson,PF,24,75,1904,351,662,0.53,0,1,0.0,351,661,0.531,0.53,118,156,0.756,140,311,451,73,33,60,100,257,820,OOR
Steve Johnson,C,24,78,1741,395,644,0.613,0,0,0.0,395,644,0.613,0.613,212,330,0.642,152,307,459,91,39,89,197,372,1002,OOR
Vinnie Johnson,SG,25,74,1295,217,444,0.489,3,12,0.25,214,432,0.495,0.492,107,142,0.754,82,77,159,171,56,25,96,101,544,OOR
Bobby Jones,PF,30,76,2181,416,737,0.564,0,3,0.0,416,734,0.567,0.564,263,333,0.79,109,284,393,189,99,112,145,211,1095,OOR
Caldwell Jones,C,31,81,2446,231,465,0.497,0,3,0.0,231,462,0.5,0.497,179,219,0.817,164,544,708,100,38,146,155,301,641,OOR
Dwight Jones,PF,29,78,2040,303,572,0.53,1,1,1.0,302,571,0.529,0.531,172,238,0.723,156,351,507,114,49,36,155,217,779,OOR
Edgar Jones,PF,25,48,802,142,259,0.548,1,2,0.5,141,257,0.549,0.55,90,129,0.698,70,137,207,40,28,92,66,149,375,OOR
Major Jones,PF,28,60,746,113,213,0.531,0,3,0.0,113,210,0.538,0.531,42,77,0.545,80,122,202,25,20,29,50,100,268,OOR
Eddie Jordan,PG,27,58,608,89,208,0.428,1,9,0.111,88,199,0.442,0.43,43,54,0.796,4,39,43,131,62,1,66,98,222,OOR
Jeff Judkins,SF,25,30,251,31,81,0.383,1,10,0.1,30,71,0.423,0.389,16,26,0.615,14,20,34,14,6,5,9,33,79,OOR
Clarence Kea,PF,22,35,248,26,49,0.531,0,0,0.0,26,49,0.531,0.531,29,42,0.69,26,35,61,14,4,3,16,55,81,OOR
Rich Kelley,C,28,81,1892,236,505,0.467,0,1,0.0,236,504,0.468,0.467,167,223,0.749,168,329,497,293,64,71,244,292,639,OOR
Greg Kelser,SF,24,60,741,116,271,0.428,0,3,0.0,116,268,0.433,0.428,105,160,0.656,80,113,193,57,18,21,84,131,337,OOR
Larry Kenon,PF,29,60,1036,192,412,0.466,0,0,0.0,192,412,0.466,0.466,50,88,0.568,72,108,180,65,30,7,82,71,434,OOR
Albert King,SF,22,76,1694,391,812,0.482,3,13,0.231,388,799,0.486,0.483,133,171,0.778,105,207,312,142,64,36,180,261,918,OOR
Bernard King,SF,25,79,2861,740,1307,0.566,1,5,0.2,739,1302,0.568,0.567,352,499,0.705,140,329,469,282,78,23,267,285,1833,OOR
Reggie King,SF,24,80,2609,383,752,0.509,0,0,0.0,383,752,0.509,0.509,201,285,0.705,162,361,523,173,84,29,155,221,967,OOR
Billy Knight,SF,29,81,1803,378,764,0.495,9,32,0.281,369,732,0.504,0.501,233,282,0.826,97,160,257,118,63,14,137,132,998,OOR
Toby Knight,SF,26,40,550,102,183,0.557,0,0,0.0,102,183,0.557,0.557,17,25,0.68,33,49,82,23,14,11,21,74,221,OOR
Joel Kramer,PF,26,56,549,55,133,0.414,0,0,0.0,55,133,0.414,0.414,33,42,0.786,36,72,108,51,19,11,26,62,143,OOR
Kevin Kunnert,C,30,21,237,20,48,0.417,0,0,0.0,20,48,0.417,0.417,9,17,0.529,20,46,66,18,3,6,18,51,49,OOR
Mitch Kupchak,PF,27,26,821,153,267,0.573,0,0,0.0,153,267,0.573,0.573,65,98,0.663,64,146,210,33,12,10,43,80,371,OOR
Sam Lacey,C,33,56,670,67,154,0.435,0,1,0.0,67,153,0.438,0.435,27,37,0.73,20,87,107,77,22,38,56,139,161,OOR
Tom LaGarde,C,26,47,909,113,269,0.42,0,2,0.0,113,267,0.423,0.42,86,166,0.518,63,147,210,49,17,17,82,138,312,OOR
Bill Laimbeer,C,24,80,1829,265,536,0.494,4,13,0.308,261,523,0.499,0.498,184,232,0.793,234,383,617,100,39,64,121,296,718,OOR
John Lambert,PF,29,63,764,86,197,0.437,1,7,0.143,85,190,0.447,0.439,34,42,0.81,55,123,178,37,18,16,48,123,207,OOR
Jeff Lamp,SF,22,54,617,100,196,0.51,0,1,0.0,100,195,0.513,0.51,50,61,0.82,24,40,64,28,16,1,45,83,250,OOR
Mark Landsberger,PF,26,75,1134,144,329,0.438,0,2,0.0,144,327,0.44,0.438,33,65,0.508,164,237,401,32,10,7,49,134,321,OOR
Bob Lanier,C,33,74,1986,407,729,0.558,0,2,0.0,407,727,0.56,0.558,182,242,0.752,92,296,388,219,72,56,166,211,996,OOR
Allen Leavell,PG,24,79,2150,370,793,0.467,9,31,0.29,361,762,0.474,0.472,115,135,0.852,49,119,168,457,150,15,153,182,864,OOR
Rock Lee,C,26,2,10,1,2,0.5,0,0,0.0,1,2,0.5,0.5,0,4,0.0,0,1,1,2,0,0,0,3,2,OOR
Ron Lee,PG,29,81,1467,88,246,0.358,18,59,0.305,70,187,0.374,0.394,84,119,0.706,35,120,155,312,116,20,123,221,278,OOR
Ronnie Lester,PG,23,75,2252,329,657,0.501,4,8,0.5,325,649,0.501,0.504,208,256,0.813,75,138,213,362,80,14,185,158,870,OOR
Alton Lister,C,23,80,1186,149,287,0.519,0,0,0.0,149,287,0.519,0.519,64,123,0.52,108,279,387,84,18,118,129,239,362,OOR
Lewis Lloyd,SG,22,16,95,25,45,0.556,0,0,0.0,25,45,0.556,0.556,7,11,0.636,9,7,16,6,5,1,14,20,57,OOR
Scott Lloyd,PF,29,74,1047,108,285,0.379,2,4,0.5,106,281,0.377,0.382,69,91,0.758,60,103,163,67,15,7,59,175,287,OOR
Kevin Loder,SF,22,71,1139,208,448,0.464,0,11,0.0,208,437,0.476,0.464,77,107,0.72,69,126,195,88,35,30,68,147,493,OOR
John Long,SG,25,69,2211,637,1294,0.492,2,15,0.133,635,1279,0.496,0.493,238,275,0.865,95,162,257,148,65,25,167,173,1514,OOR
John Lucas,PG,28,79,1940,263,618,0.426,2,22,0.091,261,596,0.438,0.427,138,176,0.784,40,126,166,551,95,6,156,105,666,OOR
Maurice Lucas,PF,29,80,2671,505,1001,0.504,0,3,0.0,505,998,0.506,0.504,253,349,0.725,274,629,903,179,68,70,173,309,1263,OOR
Ollie Mack,SG,24,13,150,19,59,0.322,0,2,0.0,19,57,0.333,0.322,6,8,0.75,8,10,18,14,5,1,4,6,44,OOR
Rudy Macklin,SF,23,79,1516,210,484,0.434,0,3,0.0,210,481,0.437,0.434,134,173,0.775,113,150,263,47,40,20,112,225,554,OOR
Kyle Macy,PG,24,82,2845,486,945,0.514,39,100,0.39,447,845,0.529,0.535,152,169,0.899,78,183,261,384,143,9,125,185,1163,OOR
Rick Mahorn,PF,23,80,2664,414,816,0.507,0,3,0.0,414,813,0.509,0.507,148,234,0.632,149,555,704,150,57,138,162,349,976,OOR
Moses Malone,C,26,81,3398,945,1822,0.519,0,6,0.0,945,1816,0.52,0.519,630,827,0.762,558,630,1188,142,76,125,294,208,2520,MVP
Wes Matthews,PG,22,47,837,131,298,0.44,2,8,0.25,129,290,0.445,0.443,60,79,0.759,19,39,58,139,53,2,63,129,324,OOR
Cedric Maxwell,SF,26,78,2590,397,724,0.548,0,3,0.0,397,721,0.551,0.548,357,478,0.747,218,281,499,183,79,49,174,263,1151,OOR
Scott May,SF,27,65,1187,212,417,0.508,0,4,0.0,212,413,0.513,0.508,159,193,0.824,85,133,218,133,50,6,92,151,583,OOR
Bob McAdoo,C,30,41,746,151,330,0.458,0,5,0.0,151,325,0.465,0.458,90,126,0.714,45,114,159,32,22,36,51,109,392,OOR
John McCullough,SG,25,8,23,9,13,0.692,0,0,0.0,9,13,0.692,0.692,3,5,0.6,1,3,4,3,2,0,3,3,21,OOR
Hank McDowell,PF,22,30,335,34,84,0.405,0,0,0.0,34,84,0.405,0.405,27,41,0.659,41,59,100,20,6,8,21,52,95,OOR
Jim McElroy,PG,28,20,349,52,125,0.416,1,5,0.2,51,120,0.425,0.42,29,36,0.806,6,11,17,39,8,3,22,44,134,OOR
Mike McGee,SF,22,39,352,80,172,0.465,0,4,0.0,80,168,0.476,0.465,31,53,0.585,34,15,49,16,18,3,34,59,191,OOR
George McGinnis,PF,31,76,1341,141,378,0.373,0,3,0.0,141,375,0.376,0.373,72,159,0.453,93,305,398,204,96,28,131,198,354,OOR
Kevin McHale,PF,24,82,2332,465,875,0.531,0,0,0.0,465,875,0.531,0.531,187,248,0.754,191,365,556,91,30,185,137,264,1117,OOR
Kevin McKenna,SG,23,36,237,28,87,0.322,0,2,0.0,28,85,0.329,0.322,11,17,0.647,18,11,29,14,10,2,20,45,67,OOR
Billy McKinney,PG,26,81,1963,369,699,0.528,0,17,0.0,369,682,0.541,0.528,137,170,0.806,29,113,142,338,69,16,115,186,875,OOR
Tom McMillen,C,29,73,1792,291,572,0.509,1,3,0.333,290,569,0.51,0.51,140,170,0.824,102,234,336,129,25,24,124,202,723,OOR
Joe Meriweather,C,28,18,380,47,91,0.516,0,0,0.0,47,91,0.516,0.516,31,40,0.775,25,63,88,17,13,21,25,68,125,OOR
Mike Mitchell,SF,26,84,3063,753,1477,0.51,0,7,0.0,753,1470,0.512,0.51,220,302,0.728,244,346,590,82,60,43,153,277,1726,OOR
Steve Mix,SF,34,75,1235,202,399,0.506,1,4,0.25,201,395,0.509,0.508,136,172,0.791,92,133,225,93,42,17,67,86,541,OOR
Paul Mokeski,C,25,67,868,84,193,0.435,0,3,0.0,84,190,0.442,0.435,48,63,0.762,59,149,208,35,33,40,55,171,216,OOR
Sidney Moncrief,SG,24,80,2980,556,1063,0.523,1,14,0.071,555,1049,0.529,0.524,468,573,0.817,221,313,534,382,138,22,208,206,1581,OOR
Johnny Moore,PG,23,79,2294,309,667,0.463,1,21,0.048,308,646,0.477,0.464,122,182,0.67,62,213,275,762,163,12,175,254,741,OOR
Lowes Moore,PG,24,4,70,19,38,0.5,1,5,0.2,18,33,0.545,0.513,6,8,0.75,1,3,4,15,6,1,5,15,45,OOR
Calvin Murphy,PG,33,64,1204,277,648,0.427,1,16,0.063,276,632,0.437,0.428,100,110,0.909,20,41,61,163,43,1,82,142,655,OOR
Larry Nance,PF,22,80,1186,227,436,0.521,0,1,0.0,227,435,0.522,0.521,75,117,0.641,95,161,256,82,42,71,104,169,529,OOR
Swen Nater,C,32,21,575,101,175,0.577,1,1,1.0,100,174,0.575,0.58,59,79,0.747,46,146,192,30,6,9,48,64,262,OOR
Calvin Natt,SF,25,75,2599,515,894,0.576,2,8,0.25,513,886,0.579,0.577,294,392,0.75,193,420,613,150,62,36,140,175,1326,OOR
Mike Newlin,SG,33,76,1507,286,615,0.465,7,23,0.304,279,592,0.471,0.471,126,147,0.857,36,55,91,170,33,3,104,194,705,OOR
Carl Nicks,SG,23,80,1322,252,555,0.454,0,5,0.0,252,550,0.458,0.454,85,150,0.567,67,94,161,89,66,4,101,184,589,OOR
Kurt Nimphius,C,23,63,1085,137,297,0.461,0,0,0.0,137,297,0.461,0.461,63,108,0.583,92,203,295,61,17,82,56,190,337,OOR
Norm Nixon,PG,26,82,3024,628,1274,0.493,3,12,0.25,625,1262,0.495,0.494,181,224,0.808,38,138,176,652,132,7,238,264,1440,OOR
Mike O'Koren,SF,23,80,2018,383,778,0.492,8,23,0.348,375,755,0.497,0.497,135,189,0.714,111,194,305,192,83,13,147,175,909,OOR
Mark Olberding,PF,25,68,2098,333,705,0.472,2,12,0.167,331,693,0.478,0.474,273,338,0.808,118,321,439,202,57,29,139,253,941,OOR
Jawann Oldham,C,24,22,124,13,36,0.361,0,0,0.0,13,36,0.361,0.361,8,14,0.571,7,17,24,3,2,10,6,28,34,OOR
Louis Orr,SF,23,80,1951,357,719,0.497,1,8,0.125,356,711,0.501,0.497,203,254,0.799,127,204,331,134,56,26,137,182,918,OOR
Tom Owens,PF,32,74,1599,299,636,0.47,1,2,0.5,298,634,0.47,0.471,181,226,0.801,142,230,372,127,41,37,137,259,780,OOR
Robert Parish,C,28,80,2534,669,1235,0.542,0,0,0.0,669,1235,0.542,0.542,252,355,0.71,288,578,866,140,68,192,221,267,1590,Candidate
Sonny Parker,SF,26,71,899,116,245,0.473,0,0,0.0,116,245,0.473,0.473,48,72,0.667,73,104,177,89,39,11,51,101,280,OOR
Billy Paultz,C,33,65,807,89,226,0.394,0,0,0.0,89,226,0.394,0.394,34,65,0.523,54,126,180,41,15,22,45,99,212,OOR
Jim Paxson,SG,24,82,2756,662,1258,0.526,8,35,0.229,654,1223,0.535,0.529,220,287,0.767,75,146,221,276,129,12,144,159,1552,OOR
Sam Pellom,PF,30,69,1037,114,251,0.454,0,1,0.0,114,250,0.456,0.454,61,79,0.772,90,139,229,28,29,47,57,164,289,OOR
Roger Phegley,SG,25,81,1183,233,507,0.46,5,31,0.161,228,476,0.479,0.464,85,109,0.78,61,93,154,114,36,8,66,152,556,OOR
Ben Poquette,PF,26,82,1698,220,428,0.514,3,10,0.3,217,418,0.519,0.518,97,120,0.808,117,294,411,94,51,65,69,235,540,OOR
Mark Radford,SG,22,43,369,54,100,0.54,2,3,0.667,52,97,0.536,0.55,35,69,0.507,13,16,29,57,16,2,42,65,145,OOR
Ed Rains,SF,25,49,637,77,177,0.435,0,2,0.0,77,175,0.44,0.435,38,64,0.594,37,43,80,40,18,2,25,74,192,OOR
Kurt Rambis,PF,23,64,1131,118,228,0.518,0,1,0.0,118,227,0.52,0.518,59,117,0.504,116,232,348,56,60,76,77,167,295,OOR
Kelvin Ransey,PG,23,78,2418,504,1095,0.46,3,38,0.079,501,1057,0.474,0.462,242,318,0.761,39,147,186,555,97,4,229,169,1253,OOR
James Ray,PF,24,40,262,51,116,0.44,1,1,1.0,50,115,0.435,0.444,21,36,0.583,18,47,65,26,10,16,37,59,124,OOR
Robert Reid,SF,26,77,2913,437,958,0.456,1,10,0.1,436,948,0.46,0.457,160,214,0.748,175,336,511,314,115,48,157,297,1035,OOR
Kevin Restani,PF,30,47,483,32,88,0.364,0,2,0.0,32,86,0.372,0.364,10,16,0.625,39,73,112,22,11,11,20,56,74,OOR
Clint Richardson,SG,25,77,1040,140,310,0.452,2,2,1.0,138,308,0.448,0.455,69,88,0.784,55,63,118,109,36,9,79,109,351,OOR
Micheal Ray Richardson,PG,26,82,3044,619,1343,0.461,19,101,0.188,600,1242,0.483,0.468,212,303,0.7,177,388,565,572,213,41,291,317,1469,OOR
Rick Robey,C,26,80,1186,185,375,0.493,0,2,0.0,185,373,0.496,0.493,84,157,0.535,114,181,295,68,27,14,92,183,454,OOR
Cliff Robinson,PF,21,68,2175,518,1143,0.453,0,4,0.0,518,1139,0.455,0.453,222,313,0.709,174,435,609,120,88,103,149,222,1258,OOR
Jackie Robinson,SF,26,3,29,3,9,0.333,0,0,0.0,3,9,0.333,0.333,4,4,1.0,3,0,3,0,0,0,1,1,10,OOR
Truck Robinson,PF,30,74,2745,579,1128,0.513,1,1,1.0,578,1127,0.513,0.514,255,371,0.687,202,519,721,179,42,28,202,215,1414,OOR
Bill Robinzine,PF,29,56,651,131,294,0.446,0,0,0.0,131,294,0.446,0.446,61,75,0.813,56,88,144,49,37,5,83,156,323,OOR
Dave Robisch,C,32,12,257,48,106,0.453,0,0,0.0,48,106,0.453,0.453,48,55,0.873,14,49,63,32,3,4,13,29,144,OOR
John Roche,SG,32,39,501,68,150,0.453,23,52,0.442,45,98,0.459,0.53,28,38,0.737,4,19,23,89,15,2,29,40,187,OOR
Tree Rollins,C,26,79,2018,202,346,0.584,0,0,0.0,202,346,0.584,0.584,79,129,0.612,168,443,611,59,35,224,79,285,483,OOR
Lorenzo Romar,PG,23,79,1259,203,403,0.504,3,15,0.2,200,388,0.515,0.507,79,96,0.823,12,86,98,226,60,13,89,103,488,OOR
Dan Roundfield,PF,28,61,2217,424,910,0.466,1,5,0.2,423,905,0.467,0.466,285,375,0.76,227,494,721,162,64,93,183,210,1134,OOR
Jeff Ruland,C,23,82,2214,420,749,0.561,1,3,0.333,419,746,0.562,0.561,342,455,0.752,253,509,762,134,44,58,237,319,1183,OOR
Campy Russell,SF,30,77,2358,410,858,0.478,25,57,0.439,385,801,0.481,0.492,228,294,0.776,86,150,236,284,77,12,195,221,1073,OOR
DeWayne Scales,PF,23,3,24,1,5,0.2,0,0,0.0,1,5,0.2,0.2,1,2,0.5,2,3,5,0,1,1,2,3,3,OOR
Danny Schayes,C,22,82,1623,252,524,0.481,0,1,0.0,252,523,0.482,0.481,140,185,0.757,131,296,427,146,46,72,151,292,644,OOR
Alvin Scott,SF,26,81,1740,189,380,0.497,0,2,0.0,189,378,0.5,0.497,108,148,0.73,97,197,294,149,59,70,98,169,486,OOR
Craig Shelton,SF,24,4,21,2,6,0.333,0,0,0.0,2,6,0.333,0.333,1,2,0.5,1,2,3,0,1,0,0,3,5,OOR
Lonnie Shelton,PF,26,81,2667,508,1046,0.486,0,8,0.0,508,1038,0.489,0.486,188,240,0.783,161,348,509,252,99,43,199,317,1204,OOR
Purvis Short,SF,24,76,1782,456,935,0.488,6,28,0.214,450,907,0.496,0.491,177,221,0.801,123,143,266,209,65,10,122,220,1095,OOR
Jerry Sichting,PG,25,51,800,91,194,0.469,1,9,0.111,90,185,0.486,0.472,29,38,0.763,14,41,55,117,33,1,42,63,212,OOR
Jack Sikma,C,26,82,3049,581,1212,0.479,2,13,0.154,579,1199,0.483,0.48,447,523,0.855,223,815,1038,277,102,107,213,268,1611,OOR
James Silas,SG,32,67,1447,251,573,0.438,0,5,0.0,251,568,0.442,0.438,246,286,0.86,26,83,109,222,40,6,107,109,748,OOR
Jim Smith,PF,23,72,858,86,169,0.509,0,0,0.0,86,169,0.509,0.509,39,85,0.459,72,110,182,46,22,51,47,185,211,OOR
Larry Smith,PF,24,74,2213,220,412,0.534,0,1,0.0,220,411,0.535,0.534,88,159,0.553,279,534,813,83,65,54,105,291,528,OOR
Phil Smith,SG,29,74,2042,340,761,0.447,5,27,0.185,335,734,0.456,0.45,163,223,0.731,51,135,186,307,67,27,155,213,848,OOR
Randy Smith,SG,33,82,2033,348,748,0.465,3,11,0.273,345,737,0.468,0.467,122,151,0.808,53,102,155,255,91,1,124,199,821,OOR
Robert Smith,PG,26,17,316,52,110,0.473,2,10,0.2,50,100,0.5,0.482,10,12,0.833,1,13,14,44,10,1,14,35,116,OOR
Ricky Sobers,SG,29,80,1938,363,801,0.453,19,76,0.25,344,725,0.474,0.465,195,254,0.768,37,105,142,301,73,18,217,238,940,OOR
Jim Spanarkel,SG,24,82,1755,270,564,0.479,8,24,0.333,262,540,0.485,0.486,279,327,0.853,99,111,210,206,86,9,111,140,827,OOR
Rory Sparrow,PG,23,82,2610,366,730,0.501,1,15,0.067,365,715,0.51,0.502,124,148,0.838,53,171,224,424,87,13,145,240,857,OOR
Larry Spriggs,SF,22,4,37,7,11,0.636,0,0,0.0,7,11,0.636,0.636,0,2,0.0,2,4,6,4,2,0,4,7,14,OOR
Kevin Stacom,SG,30,7,90,14,34,0.412,1,2,0.5,13,32,0.406,0.426,1,2,0.5,2,5,7,7,1,0,9,6,30,OOR
Brian Taylor,PG,30,41,1274,165,328,0.503,23,63,0.365,142,265,0.536,0.538,90,110,0.818,26,70,96,229,47,9,82,113,443,OOR
Carlos Terry,SG,25,13,60,3,15,0.2,0,3,0.0,3,12,0.25,0.2,3,4,0.75,5,7,12,8,3,1,5,15,9,OOR
Reggie Theus,SG,24,82,2838,560,1194,0.469,25,100,0.25,535,1094,0.489,0.479,363,449,0.808,115,197,312,476,87,16,277,243,1508,OOR
Isiah Thomas,PG,20,72,2433,453,1068,0.424,17,59,0.288,436,1009,0.432,0.432,302,429,0.704,57,152,209,565,150,17,299,253,1225,OOR
David Thompson,SG,27,61,1246,313,644,0.486,4,14,0.286,309,630,0.49,0.489,276,339,0.814,57,91,148,117,34,29,142,149,906,OOR
Mychal Thompson,C,27,79,3129,681,1303,0.523,0,0,0.0,681,1303,0.523,0.523,280,446,0.628,258,663,921,319,69,107,245,233,1642,OOR
Ray Tolbert,PF,23,64,607,100,202,0.495,0,2,0.0,100,200,0.5,0.495,19,35,0.543,50,76,126,33,12,16,45,83,219,OOR
Andrew Toney,SG,24,77,1909,511,979,0.522,25,59,0.424,486,920,0.528,0.535,227,306,0.742,43,91,134,283,64,17,214,269,1274,OOR
Raymond Townsend,SG,26,14,95,11,41,0.268,2,9,0.222,9,32,0.281,0.293,11,20,0.55,2,11,13,10,3,0,6,18,35,OOR
Kelly Tripucka,SF,22,82,3077,636,1281,0.496,5,22,0.227,631,1259,0.501,0.498,495,621,0.797,219,224,443,270,89,16,280,241,1772,OOR
Elston Turner,SF,22,80,1996,282,639,0.441,0,4,0.0,282,635,0.444,0.441,97,138,0.703,143,158,301,189,75,2,116,182,661,OOR
Terry Tyler,PF,25,82,1989,336,643,0.523,1,4,0.25,335,639,0.524,0.523,142,192,0.74,154,339,493,126,77,160,121,182,815,OOR
Darnell Valentine,PG,22,82,1387,187,453,0.413,0,9,0.0,187,444,0.421,0.413,152,200,0.76,48,101,149,270,94,3,127,187,526,OOR
Jan van Breda Kolff,SF,30,41,452,41,82,0.5,0,2,0.0,41,80,0.513,0.5,62,76,0.816,17,31,48,32,12,13,29,63,144,OOR
Kiki Vandeweghe,PF,23,82,2775,706,1260,0.56,1,13,0.077,705,1247,0.565,0.561,347,405,0.857,149,312,461,247,52,29,189,217,1760,OOR
Pete Verhoeven,PF,22,71,1207,149,296,0.503,0,0,0.0,149,296,0.503,0.503,51,72,0.708,106,148,254,52,42,22,55,215,349,OOR
Jay Vincent,PF,22,81,2626,719,1448,0.497,1,4,0.25,718,1444,0.497,0.497,293,409,0.716,182,383,565,176,89,22,194,308,1732,OOR
Danny Vranes,SF,23,77,1075,143,262,0.546,0,1,0.0,143,261,0.548,0.546,89,148,0.601,71,127,198,56,28,21,68,150,375,OOR
Foots Walker,PG,30,77,1861,156,378,0.413,3,9,0.333,153,369,0.415,0.417,141,194,0.727,31,119,150,398,120,6,107,179,456,OOR
Wally Walker,SF,27,70,1965,302,629,0.48,0,2,0.0,302,627,0.482,0.48,90,134,0.672,108,197,305,218,36,28,111,215,694,OOR
Kermit Washington,PF,30,20,418,38,78,0.487,0,0,0.0,38,78,0.487,0.487,24,41,0.585,40,77,117,29,9,16,19,56,100,OOR
Richard Washington,PF,26,18,313,50,115,0.435,0,2,0.0,50,113,0.442,0.435,9,15,0.6,32,43,75,15,8,2,35,51,109,OOR
Marvin Webster,C,29,82,1883,199,405,0.491,0,0,0.0,199,405,0.491,0.491,108,170,0.635,184,306,490,99,22,91,90,211,506,OOR
Scott Wedman,SF,29,54,1638,260,589,0.441,5,23,0.217,255,566,0.451,0.446,66,90,0.733,128,176,304,133,73,14,73,189,591,OOR
Paul Westphal,SG,31,18,451,86,194,0.443,2,8,0.25,84,186,0.452,0.448,36,47,0.766,9,13,22,100,19,8,47,61,210,OOR
Jerome Whitehead,C,25,72,2214,406,726,0.559,0,0,0.0,406,726,0.559,0.559,184,241,0.763,231,433,664,102,48,44,141,290,996,OOR
Hawkeye Whitney,SG,24,23,266,25,71,0.352,0,1,0.0,25,70,0.357,0.352,4,7,0.571,13,27,40,19,12,1,14,31,54,OOR
Michael Wiley,PF,24,61,1013,203,359,0.565,0,5,0.0,203,354,0.573,0.565,98,141,0.695,67,115,182,52,40,16,71,127,504,OOR
Bob Wilkerson,SF,27,65,1805,284,679,0.418,3,18,0.167,281,661,0.425,0.42,145,185,0.784,60,190,250,237,92,25,138,188,716,OOR
Jamaal Wilkes,SF,28,82,2906,744,1417,0.525,0,4,0.0,744,1413,0.527,0.525,246,336,0.732,153,240,393,143,89,24,164,240,1734,OOR
James Wilkes,SF,23,57,862,128,266,0.481,0,1,0.0,128,265,0.483,0.481,58,80,0.725,62,97,159,64,30,18,62,112,314,OOR
Jeff Wilkins,C,26,82,2274,314,718,0.437,0,3,0.0,314,715,0.439,0.437,137,176,0.778,120,491,611,90,32,77,134,248,765,OOR
Buck Williams,PF,21,82,2825,513,881,0.582,0,1,0.0,513,880,0.583,0.582,242,388,0.624,347,658,1005,107,84,84,235,285,1268,OOR
Freeman Williams,SG,25,60,997,276,623,0.443,28,94,0.298,248,529,0.469,0.465,140,166,0.843,23,39,62,86,29,0,107,103,720,OOR
Gus Williams,PG,28,80,2876,773,1592,0.486,9,40,0.225,764,1552,0.492,0.488,320,436,0.734,92,152,244,549,172,36,197,163,1875,Candidate
Herb Williams,C,23,82,2277,407,854,0.477,2,7,0.286,405,847,0.478,0.478,126,188,0.67,175,430,605,139,53,178,137,200,942,OOR
Ray Williams,SG,27,82,2732,639,1383,0.462,9,54,0.167,630,1329,0.474,0.465,387,465,0.832,117,208,325,488,199,43,290,302,1674,OOR
Sam Williams,PF,22,59,1073,154,277,0.556,0,0,0.0,154,277,0.556,0.556,49,89,0.551,91,217,308,38,45,76,64,156,357,OOR
Sly Williams,SF,24,60,1521,349,628,0.556,2,9,0.222,347,619,0.561,0.557,131,173,0.757,100,127,227,142,77,16,114,153,831,OOR
Bill Willoughby,SF,24,69,1475,240,464,0.517,3,7,0.429,237,457,0.519,0.52,56,77,0.727,107,157,264,75,31,59,78,146,539,OOR
Brian Winters,SG,29,61,1829,404,806,0.501,36,93,0.387,368,713,0.516,0.524,123,156,0.788,51,119,170,253,57,9,118,187,967,OOR
Garry Witts,SF,22,46,493,49,84,0.583,1,2,0.5,48,82,0.585,0.589,33,40,0.825,29,33,62,38,17,4,35,74,132,OOR
Al Wood,SG,23,48,930,179,381,0.47,3,24,0.125,176,357,0.493,0.474,93,119,0.782,51,83,134,58,31,9,71,108,454,OOR
Howard Wood,SF,22,42,342,55,120,0.458,0,1,0.0,55,119,0.462,0.458,34,52,0.654,22,43,65,9,8,6,15,37,144,OOR
Mike Woodson,SG,23,83,2331,538,1069,0.503,7,25,0.28,531,1044,0.509,0.507,221,286,0.773,102,145,247,222,142,35,153,220,1304,OOR
Orlando Woolridge,SF,22,75,1188,202,394,0.513,0,3,0.0,202,391,0.517,0.513,144,206,0.699,82,145,227,81,23,24,107,152,548,OOR
Sam Worthen,PG,24,5,22,2,5,0.4,0,0,0.0,2,5,0.4,0.4,0,0,0.0,1,0,1,3,0,0,2,3,4,OOR
Larry Wright,PG,27,1,6,0,1,0.0,0,0,0.0,0,1,0.0,0.0,0,0,0.0,0,0,0,0,0,0,1,2,0,OOR
Rich Yonakor,PF,23,10,70,14,26,0.538,0,0,0.0,14,26,0.538,0.538,5,7,0.714,13,14,27,3,1,2,2,7,33,OOR
