Player,Pos,Age,G,MP,FG,FGA,FG%,3P,3PA,3P%,2P,2PA,2P%,eFG%,FT,FTA,FT%,ORB,DRB,TRB,AST,STL,BLK,TOV,PF,PTS,Status,Season
Kareem Abdul-Jabbar,C,36,80,2622,716,1238,0.578,0,1,0.0,716,1237,0.579,0.578,285,394,0.723,169,418,587,211,55,143,221,211,1717,Candidate,1984
Alvan Adams,C,29,70,1452,269,582,0.462,0,4,0.0,269,578,0.465,0.462,132,160,0.825,118,201,319,219,73,31,117,195,670,OOR,1984
Mark Aguirre,SF,24,79,2900,925,1765,0.524,15,56,0.268,910,1709,0.532,0.528,465,621,0.749,161,308,469,358,80,22,285,246,2330,OOR,1984
Danny Ainge,SG,24,71,1154,166,361,0.46,6,22,0.273,160,339,0.472,0.468,46,56,0.821,29,87,116,162,41,4,70,143,384,OOR,1984
J.J. Anderson,SF,23,48,311,55,130,0.423,0,3,0.0,55,127,0.433,0.423,12,29,0.414,38,25,63,22,15,9,20,28,122,OOR,1984
Richard Anderson,PF,23,78,1380,272,638,0.426,3,19,0.158,269,619,0.435,0.429,116,150,0.773,136,270,406,193,46,28,109,183,663,OOR,1984
Tiny Archibald,PG,35,46,1038,136,279,0.487,4,18,0.222,132,261,0.506,0.495,64,101,0.634,16,60,76,160,33,0,78,78,340,OOR,1984
Ken Austin,SF,22,7,28,6,13,0.462,0,0,0.0,6,13,0.462,0.462,0,0,0.0,2,1,3,1,1,1,3,7,12,OOR,1984
John Bagley,PG,23,76,1712,257,607,0.423,2,17,0.118,255,590,0.432,0.425,157,198,0.793,49,107,156,333,78,4,170,113,673,OOR,1984
James Bailey,PF,26,73,1174,254,517,0.491,0,1,0.0,254,516,0.492,0.491,138,192,0.719,104,190,294,79,33,40,101,197,646,OOR,1984
Thurl Bailey,PF,22,81,2009,302,590,0.512,0,0,0.0,302,590,0.512,0.512,88,117,0.752,115,349,464,129,38,122,105,193,692,OOR,1984
Greg Ballard,SF,29,82,2701,510,1061,0.481,2,15,0.133,508,1046,0.486,0.482,166,208,0.798,140,348,488,290,94,35,142,214,1188,OOR,1984
Gene Banks,PF,24,80,2600,424,747,0.568,1,6,0.167,423,741,0.571,0.568,200,270,0.741,204,378,582,254,105,23,166,256,1049,OOR,1984
Dave Batton,C,27,4,31,5,10,0.5,0,0,0.0,5,10,0.5,0.5,0,0,0.0,1,3,4,3,0,3,4,5,10,OOR,1984
Kent Benson,C,29,82,1734,248,451,0.55,0,1,0.0,248,450,0.551,0.55,83,101,0.822,117,292,409,130,71,53,79,230,579,OOR,1984
Larry Bird,PF,27,79,3028,758,1542,0.492,18,73,0.247,740,1469,0.504,0.497,374,421,0.888,181,615,796,520,144,69,237,197,1908,MVP,1984
Otis Birdsong,SG,28,69,2168,583,1147,0.508,5,20,0.25,578,1127,0.513,0.51,194,319,0.608,74,96,170,266,86,17,170,180,1365,OOR,1984
Rolando Blackman,SG,24,81,3025,721,1320,0.546,1,11,0.091,720,1309,0.55,0.547,372,458,0.812,124,249,373,288,56,37,169,127,1815,OOR,1984
Tom Boswell,PF,30,38,261,28,52,0.538,1,1,1.0,27,51,0.529,0.548,16,21,0.762,28,36,64,16,9,0,13,58,73,OOR,1984
Charles Bradley,SG,24,8,39,3,7,0.429,0,0,0.0,3,7,0.429,0.429,5,7,0.714,0,3,3,5,0,1,8,6,11,OOR,1984
Mike Bratz,PG,28,82,1428,213,521,0.409,15,51,0.294,198,470,0.421,0.423,120,137,0.876,41,102,143,252,84,6,109,155,561,OOR,1984
Randy Breuer,C,23,57,472,68,177,0.384,0,0,0.0,68,177,0.384,0.384,32,46,0.696,48,61,109,17,11,38,35,98,168,OOR,1984
Ron Brewer,SG,28,53,992,179,403,0.444,3,14,0.214,176,389,0.452,0.448,52,67,0.776,22,41,63,50,24,21,40,64,413,OOR,1984
Junior Bridgeman,SF,30,81,2431,509,1094,0.465,6,31,0.194,503,1063,0.473,0.468,196,243,0.807,80,252,332,265,53,14,148,224,1220,OOR,1984
Michael Brooks,SF,25,47,1405,213,445,0.479,0,5,0.0,213,440,0.484,0.479,104,151,0.689,142,200,342,88,50,14,78,125,530,OOR,1984
Fred Brown,SG,35,71,1129,258,506,0.51,9,34,0.265,249,472,0.528,0.519,77,86,0.895,14,48,62,194,49,2,70,84,602,OOR,1984
Rickey Brown,C,25,68,785,94,201,0.468,0,0,0.0,94,201,0.468,0.468,48,65,0.738,67,114,181,29,18,23,53,161,236,OOR,1984
Wallace Bryant,C,24,29,317,52,133,0.391,0,0,0.0,52,133,0.391,0.391,14,33,0.424,37,43,80,13,9,11,16,48,118,OOR,1984
Quinn Buckner,PG,29,79,1249,138,323,0.427,0,6,0.0,138,317,0.435,0.427,48,74,0.649,41,96,137,214,84,3,100,187,324,OOR,1984
Don Buse,PG,33,76,1327,150,352,0.426,18,59,0.305,132,293,0.451,0.452,63,80,0.788,29,87,116,303,86,1,87,62,381,OOR,1984
Kenny Carr,PF,28,82,2455,518,923,0.561,0,5,0.0,518,918,0.564,0.561,247,367,0.673,208,434,642,157,68,33,202,274,1283,OOR,1984
M.L. Carr,SF,33,60,585,70,171,0.409,3,15,0.2,67,156,0.429,0.418,42,48,0.875,26,49,75,49,17,4,46,67,185,OOR,1984
Joe Barry Carroll,C,25,80,2962,663,1390,0.477,0,1,0.0,663,1389,0.477,0.477,313,433,0.723,235,401,636,198,103,142,268,244,1639,OOR,1984
Butch Carter,SG,25,73,2045,413,862,0.479,15,46,0.326,398,816,0.488,0.488,136,178,0.764,70,83,153,206,128,13,141,211,977,OOR,1984
Howard Carter,SG,22,55,688,145,316,0.459,5,19,0.263,140,297,0.471,0.467,47,61,0.77,38,48,86,71,19,4,42,81,342,OOR,1984
Bill Cartwright,C,26,77,2487,453,808,0.561,0,1,0.0,453,807,0.561,0.561,404,502,0.805,195,454,649,107,44,97,200,262,1310,OOR,1984
Harvey Catchings,PF,32,69,1156,61,153,0.399,0,1,0.0,61,152,0.401,0.399,22,42,0.524,89,182,271,43,25,81,57,172,144,OOR,1984
Tom Chambers,PF,24,82,2570,554,1110,0.499,0,12,0.0,554,1098,0.505,0.499,375,469,0.8,219,313,532,133,47,51,192,309,1483,OOR,1984
Maurice Cheeks,PG,27,75,2494,386,702,0.55,8,20,0.4,378,682,0.554,0.556,170,232,0.733,44,161,205,478,171,20,182,196,950,OOR,1984
Carlos Clark,SG,23,31,127,19,52,0.365,0,2,0.0,19,50,0.38,0.365,16,18,0.889,7,10,17,17,8,1,12,13,54,OOR,1984
Don Collins,SG,25,61,957,187,387,0.483,1,5,0.2,186,382,0.487,0.484,65,89,0.73,62,67,129,67,43,14,80,119,440,OOR,1984
Leroy Combs,SF,23,48,446,81,163,0.497,0,3,0.0,81,160,0.506,0.497,56,91,0.615,19,37,56,38,23,18,46,49,218,OOR,1984
Lester Conner,SG,24,82,2573,360,730,0.493,1,6,0.167,359,724,0.496,0.494,186,259,0.718,132,173,305,401,162,12,143,176,907,OOR,1984
Darwin Cook,PG,25,82,1870,304,687,0.443,11,46,0.239,293,641,0.457,0.451,95,126,0.754,51,105,156,356,164,36,142,184,714,OOR,1984
Jeff Cook,C,27,81,1950,188,387,0.486,1,2,0.5,187,385,0.486,0.487,94,130,0.723,174,310,484,123,68,47,91,282,471,OOR,1984
Michael Cooper,SG,27,82,2387,273,549,0.497,38,121,0.314,235,428,0.549,0.532,155,185,0.838,53,209,262,482,113,67,148,267,739,OOR,1984
Wayne Cooper,C,27,81,1662,304,663,0.459,0,7,0.0,304,656,0.463,0.459,185,230,0.804,176,300,476,76,26,106,110,247,793,OOR,1984
Dave Corzine,C,27,82,2674,385,824,0.467,3,9,0.333,382,815,0.469,0.469,231,275,0.84,169,406,575,202,58,120,175,227,1004,OOR,1984
Charlie Criss,PG,35,15,215,20,52,0.385,1,6,0.167,19,46,0.413,0.394,12,16,0.75,5,15,20,38,8,0,10,11,53,OOR,1984
Geoff Crompton,C,28,7,23,1,8,0.125,0,0,0.0,1,8,0.125,0.125,3,6,0.5,6,3,9,1,1,1,4,4,5,OOR,1984
Russell Cross,C,22,45,354,64,112,0.571,0,0,0.0,64,112,0.571,0.571,38,91,0.418,35,47,82,22,12,7,19,58,166,OOR,1984
Pat Cummings,PF,27,80,2492,452,915,0.494,0,2,0.0,452,913,0.495,0.494,141,190,0.742,151,507,658,158,64,23,146,282,1045,OOR,1984
Terry Cummings,PF,22,81,2907,737,1491,0.494,0,3,0.0,737,1488,0.495,0.494,380,528,0.72,323,454,777,139,92,57,218,298,1854,OOR,1984
Earl Cureton,C,26,73,907,81,177,0.458,0,1,0.0,81,176,0.46,0.458,31,59,0.525,86,201,287,36,24,31,55,143,193,OOR,1984
Quintin Dailey,SG,23,82,2449,583,1229,0.474,4,32,0.125,579,1197,0.484,0.476,321,396,0.811,61,174,235,254,109,11,220,218,1491,OOR,1984
Adrian Dantley,SF,28,79,2984,802,1438,0.558,1,4,0.25,801,1434,0.559,0.558,813,946,0.859,179,269,448,310,61,4,263,201,2418,OOR,1984
Brad Davis,PG,28,81,2665,345,651,0.53,7,38,0.184,338,613,0.551,0.535,199,238,0.836,41,146,187,561,94,13,166,218,896,OOR,1984
Charles Davis,SF,25,46,467,103,218,0.472,1,9,0.111,102,209,0.488,0.475,24,39,0.615,34,69,103,30,14,10,36,58,231,OOR,1984
Johnny Davis,PG,28,75,2079,354,800,0.443,0,8,0.0,354,792,0.447,0.443,217,256,0.848,53,86,139,326,62,6,134,146,925,OOR,1984
Walter Davis,SG,29,78,2546,652,1274,0.512,20,87,0.23,632,1187,0.532,0.52,233,270,0.863,38,164,202,429,107,12,213,202,1557,OOR,1984
Darryl Dawkins,C,27,81,2417,507,855,0.593,2,5,0.4,505,850,0.594,0.594,341,464,0.735,159,382,541,123,60,136,231,386,1357,OOR,1984
Darren Daye,SF,23,75,1174,180,408,0.441,0,6,0.0,180,402,0.448,0.441,95,133,0.714,90,98,188,176,38,12,96,154,455,OOR,1984
Kenny Dennard,PF,25,43,413,36,99,0.364,3,10,0.3,33,89,0.371,0.379,15,24,0.625,37,64,101,45,23,8,29,83,90,OOR,1984
James Donaldson,C,26,82,2525,360,604,0.596,0,0,0.0,360,604,0.596,0.596,249,327,0.761,165,484,649,90,40,139,171,214,969,OOR,1984
John Drew,SF,29,81,1797,511,1067,0.479,6,22,0.273,505,1045,0.483,0.482,402,517,0.778,146,192,338,135,88,2,192,208,1430,OOR,1984
Larry Drew,PG,25,73,2363,474,1026,0.462,3,10,0.3,471,1016,0.464,0.463,243,313,0.776,33,113,146,558,121,10,194,170,1194,OOR,1984
Clyde Drexler,SG,21,82,1408,252,559,0.451,1,4,0.25,251,555,0.452,0.452,123,169,0.728,112,123,235,153,107,29,123,209,628,OOR,1984
Mike Dunleavy,PG,29,17,404,70,127,0.551,19,45,0.422,51,82,0.622,0.626,32,40,0.8,6,22,28,78,12,1,36,51,191,OOR,1984
T.R. Dunn,SG,28,80,2705,174,370,0.47,0,1,0.0,174,369,0.472,0.47,106,145,0.731,195,379,574,228,173,32,97,233,454,OOR,1984
Mark Eaton,C,27,82,2139,194,416,0.466,0,1,0.0,194,415,0.467,0.466,73,123,0.593,148,447,595,113,25,351,98,303,461,OOR,1984
Jerry Eaves,PG,24,80,1034,132,293,0.451,0,6,0.0,132,287,0.46,0.451,92,132,0.697,29,56,85,200,33,5,93,90,356,OOR,1984
Keith Edmonson,SG,23,55,622,158,321,0.492,0,0,0.0,158,321,0.492,0.492,94,126,0.746,46,42,88,34,26,7,61,83,410,OOR,1984
Franklin Edwards,PG,24,60,654,84,221,0.38,0,1,0.0,84,220,0.382,0.38,34,48,0.708,12,47,59,90,31,5,46,78,202,OOR,1984
James Edwards,C,28,72,1897,438,817,0.536,0,1,0.0,438,816,0.537,0.536,183,254,0.72,108,240,348,184,23,30,140,254,1059,OOR,1984
Craig Ehlo,SG,22,7,63,11,27,0.407,0,0,0.0,11,27,0.407,0.407,1,1,1.0,4,5,9,6,3,0,3,13,23,OOR,1984
Dale Ellis,SF,23,67,1059,225,493,0.456,12,29,0.414,213,464,0.459,0.469,87,121,0.719,106,144,250,56,41,9,78,118,549,OOR,1984
Len Elmore,PF,31,65,832,64,157,0.408,0,0,0.0,64,157,0.408,0.408,27,38,0.711,62,103,165,30,29,30,46,153,155,OOR,1984
Chris Engler,C,24,46,360,33,83,0.398,0,0,0.0,33,83,0.398,0.398,14,23,0.609,27,70,97,11,9,3,24,68,80,OOR,1984
Alex English,SF,30,82,2870,907,1714,0.529,1,7,0.143,906,1707,0.531,0.529,352,427,0.824,216,248,464,406,83,95,222,252,2167,OOR,1984
Julius Erving,SF,33,77,2683,678,1324,0.512,7,21,0.333,671,1303,0.515,0.515,364,483,0.754,190,342,532,309,141,139,230,217,1727,OOR,1984
Mike Evans,PG,28,78,1687,243,564,0.431,32,89,0.36,211,475,0.444,0.459,111,131,0.847,23,115,138,288,61,4,117,175,629,OOR,1984
Eric Fernsten,PF,30,32,402,29,52,0.558,0,0,0.0,29,52,0.558,0.558,25,34,0.735,29,57,86,11,16,8,19,49,83,OOR,1984
Sleepy Floyd,PG,23,77,2555,484,1045,0.463,8,45,0.178,476,1000,0.476,0.467,315,386,0.816,87,184,271,269,103,31,196,216,1291,OOR,1984
Phil Ford,PG,27,81,2020,236,470,0.502,2,15,0.133,234,455,0.514,0.504,98,117,0.838,28,109,137,410,59,8,135,243,572,OOR,1984
Rod Foster,PG,23,80,1424,260,580,0.448,22,84,0.262,238,496,0.48,0.467,122,155,0.787,39,81,120,172,54,9,108,193,664,OOR,1984
World B. Free,SG,30,75,2375,626,1407,0.445,22,69,0.319,604,1338,0.451,0.453,395,504,0.784,89,128,217,226,94,8,154,214,1669,OOR,1984
Bill Garnett,PF,23,80,1529,141,299,0.472,0,2,0.0,141,297,0.475,0.472,129,176,0.733,123,208,331,128,44,66,68,217,411,OOR,1984
Calvin Garrett,SF,27,41,478,78,152,0.513,2,6,0.333,76,146,0.521,0.52,30,39,0.769,24,47,71,31,12,2,34,62,188,OOR,1984
John Garris,PF,24,33,267,52,102,0.51,0,0,0.0,52,102,0.51,0.51,27,34,0.794,35,42,77,10,8,6,11,40,131,OOR,1984
George Gervin,SG,31,76,2584,765,1561,0.49,10,24,0.417,755,1537,0.491,0.493,427,507,0.842,106,207,313,220,79,47,224,219,1967,OOR,1984
Mike Gibson,PF,23,32,229,21,55,0.382,0,0,0.0,21,55,0.382,0.382,11,17,0.647,29,37,66,9,5,7,14,30,53,OOR,1984
Artis Gilmore,C,34,64,2034,351,556,0.631,0,3,0.0,351,553,0.635,0.631,280,390,0.718,213,449,662,70,36,132,149,229,982,OOR,1984
Mike Glenn,SG,28,81,1503,312,554,0.563,1,2,0.5,311,552,0.563,0.564,56,70,0.8,17,87,104,171,46,5,63,146,681,OOR,1984
Mike Gminski,C,24,82,1655,237,462,0.513,0,3,0.0,237,459,0.516,0.513,147,184,0.799,161,272,433,92,37,70,120,162,621,OOR,1984
Stewart Granger,PG,22,56,738,97,226,0.429,4,13,0.308,93,213,0.437,0.438,53,70,0.757,8,47,55,134,24,0,57,97,251,OOR,1984
Rickey Green,PG,29,81,2768,439,904,0.486,2,17,0.118,437,887,0.493,0.487,192,234,0.821,56,174,230,748,215,13,172,155,1072,OOR,1984
Sidney Green,PF,23,49,667,100,228,0.439,0,0,0.0,100,228,0.439,0.439,55,77,0.714,58,116,174,25,18,17,60,128,255,OOR,1984
Dave Greenwood,PF,26,78,2718,369,753,0.49,0,1,0.0,369,752,0.491,0.49,213,289,0.737,214,572,786,139,67,72,149,265,951,OOR,1984
Kevin Grevey,SG,30,64,923,178,395,0.451,15,53,0.283,163,342,0.477,0.47,75,84,0.893,30,51,81,75,27,4,45,95,446,OOR,1984
Darrell Griffith,SG,25,82,2650,697,1423,0.49,91,252,0.361,606,1171,0.518,0.522,151,217,0.696,95,243,338,283,114,23,243,202,1636,OOR,1984
Ernie Grunfeld,SG,28,76,1119,166,362,0.459,2,9,0.222,164,353,0.465,0.461,64,83,0.771,24,97,121,108,43,7,71,151,398,OOR,1984
Bob Hansen,SG,23,55,419,65,145,0.448,0,8,0.0,65,137,0.474,0.448,18,28,0.643,13,35,48,44,15,4,35,62,148,OOR,1984
Bill Hanzlik,SF,26,80,1469,132,306,0.431,3,12,0.25,129,294,0.439,0.436,167,207,0.807,66,139,205,252,68,19,109,255,434,OOR,1984
Derek Harper,PG,22,82,1712,200,451,0.443,3,26,0.115,197,425,0.464,0.447,66,98,0.673,53,119,172,239,95,21,111,143,469,OOR,1984
Scott Hastings,PF,23,68,1135,111,237,0.468,1,4,0.25,110,233,0.472,0.47,82,104,0.788,96,174,270,46,40,36,66,220,305,OOR,1984
Steve Hawes,PF,33,79,1153,114,237,0.481,1,4,0.25,113,233,0.485,0.483,61,78,0.782,50,170,220,99,24,16,52,144,290,OOR,1984
Elvin Hayes,PF,38,81,994,158,389,0.406,0,2,0.0,158,387,0.408,0.406,86,132,0.652,87,173,260,71,16,28,82,123,402,OOR,1984
Steve Hayes,C,28,43,253,26,50,0.52,0,0,0.0,26,50,0.52,0.52,5,14,0.357,19,43,62,13,5,18,13,52,57,OOR,1984
Gerald Henderson,PG,28,78,2088,376,718,0.524,20,57,0.351,356,661,0.539,0.538,136,177,0.768,68,79,147,300,117,14,161,209,908,OOR,1984
Rod Higgins,SF,24,78,1577,193,432,0.447,1,22,0.045,192,410,0.468,0.448,113,156,0.724,87,119,206,116,49,29,76,161,500,OOR,1984
Johnny High,PG,26,29,512,18,52,0.346,0,2,0.0,18,50,0.36,0.346,10,29,0.345,16,50,66,51,40,11,38,84,46,OOR,1984
Armond Hill,PG,30,15,181,14,46,0.304,0,0,0.0,14,46,0.304,0.304,17,21,0.81,2,8,10,35,7,0,14,30,45,OOR,1984
Roy Hinson,SF,22,80,1858,184,371,0.496,0,0,0.0,184,371,0.496,0.496,69,117,0.59,175,324,499,69,31,145,109,306,437,OOR,1984
Craig Hodges,SG,23,76,1571,258,573,0.45,10,46,0.217,248,527,0.471,0.459,66,88,0.75,22,64,86,116,58,1,85,166,592,OOR,1984
Lionel Hollins,PG,30,32,216,24,63,0.381,0,2,0.0,24,61,0.393,0.381,11,13,0.846,4,18,22,62,13,1,24,26,59,OOR,1984
Phil Hubbard,SF,27,80,1799,321,628,0.511,0,1,0.0,321,627,0.512,0.511,221,299,0.739,172,208,380,86,71,6,115,244,863,OOR,1984
Geoff Huston,PG,26,77,2041,348,699,0.498,2,11,0.182,346,688,0.503,0.499,110,154,0.714,32,64,96,413,38,1,145,126,808,OOR,1984
Marc Iavaroni,PF,27,78,1532,149,322,0.463,0,2,0.0,149,320,0.466,0.463,97,131,0.74,91,219,310,95,36,55,124,222,395,OOR,1984
Dan Issel,C,35,76,2076,569,1153,0.493,4,19,0.211,565,1134,0.498,0.495,364,428,0.85,112,401,513,173,60,44,122,182,1506,OOR,1984
Tracy Jackson,SG,24,2,10,1,4,0.25,0,0,0.0,1,4,0.25,0.25,4,4,1.0,1,0,1,0,0,0,1,3,6,OOR,1984
Clay Johnson,SG,27,25,176,20,50,0.4,1,1,1.0,19,49,0.388,0.41,14,22,0.636,6,6,12,14,8,2,12,24,55,OOR,1984
Clemon Johnson,C,27,80,1721,193,412,0.468,0,0,0.0,193,412,0.468,0.468,69,113,0.611,131,267,398,55,35,65,95,205,455,OOR,1984
Dennis Johnson,SG,29,80,2665,384,878,0.437,4,32,0.125,380,846,0.449,0.44,281,330,0.852,87,193,280,338,93,57,172,251,1053,OOR,1984
Eddie Johnson,SG,28,67,1893,353,798,0.442,16,43,0.372,337,755,0.446,0.452,164,213,0.77,31,115,146,374,58,7,173,155,886,OOR,1984
Eddie Johnson,SF,24,82,2920,753,1552,0.485,20,64,0.313,733,1488,0.493,0.492,268,331,0.81,165,290,455,296,76,21,213,266,1794,OOR,1984
Frank Johnson,PG,25,82,2686,392,840,0.467,11,43,0.256,381,797,0.478,0.473,187,252,0.742,58,126,184,567,96,6,191,174,982,OOR,1984
George Johnson,SF,27,81,2073,411,884,0.465,11,47,0.234,400,837,0.478,0.471,223,270,0.826,139,321,460,195,82,49,186,256,1056,OOR,1984
Magic Johnson,PG,24,67,2567,441,780,0.565,6,29,0.207,435,751,0.579,0.569,290,358,0.81,99,392,491,875,150,49,306,169,1178,Candidate,1984
Marques Johnson,SF,27,74,2715,646,1288,0.502,2,13,0.154,644,1275,0.505,0.502,241,340,0.709,173,307,480,315,115,45,180,194,1535,OOR,1984
Mickey Johnson,PF,31,78,2122,359,852,0.421,5,29,0.172,354,823,0.43,0.424,339,432,0.785,198,320,518,219,101,30,216,290,1062,OOR,1984
Reggie Johnson,PF,26,72,818,127,256,0.496,0,1,0.0,127,255,0.498,0.496,92,126,0.73,53,85,138,40,24,18,59,141,346,OOR,1984
Steve Johnson,C,26,81,1487,302,540,0.559,0,0,0.0,302,540,0.559,0.559,165,287,0.575,162,256,418,81,37,69,164,307,769,OOR,1984
Vinnie Johnson,SG,27,82,1909,426,901,0.473,4,19,0.211,422,882,0.478,0.475,207,275,0.753,130,107,237,271,44,19,135,196,1063,OOR,1984
Bobby Jones,PF,32,75,1761,226,432,0.523,0,1,0.0,226,431,0.524,0.523,167,213,0.784,92,231,323,187,107,103,101,199,619,OOR,1984
Caldwell Jones,C,33,81,2506,318,633,0.502,1,3,0.333,317,630,0.503,0.503,164,196,0.837,168,414,582,156,46,80,158,335,801,OOR,1984
Charles Jones,PF,26,1,3,0,1,0.0,0,0,0.0,0,1,0.0,0.0,1,4,0.25,0,0,0,0,0,0,0,1,1,OOR,1984
Edgar Jones,PF,27,81,1770,322,644,0.5,6,19,0.316,316,625,0.506,0.505,176,242,0.727,143,306,449,85,64,107,125,298,826,OOR,1984
Hutch Jones,SF,24,4,18,0,3,0.0,0,0,0.0,0,3,0.0,0.0,1,4,0.25,0,0,0,0,1,0,2,0,1,OOR,1984
Major Jones,PF,30,57,473,70,130,0.538,0,0,0.0,70,130,0.538,0.538,30,49,0.612,33,82,115,28,14,14,30,63,170,OOR,1984
Mark Jones,PG,22,6,16,3,6,0.5,0,1,0.0,3,5,0.6,0.5,1,2,0.5,2,0,2,5,0,0,2,2,7,OOR,1984
Eddie Jordan,PG,29,16,210,17,49,0.347,0,3,0.0,17,46,0.37,0.347,8,12,0.667,3,14,17,44,25,0,26,37,42,OOR,1984
Rich Kelley,C,30,75,1674,132,264,0.5,0,0,0.0,132,264,0.5,0.5,124,162,0.765,140,350,490,157,55,29,148,273,388,OOR,1984
Clark Kellogg,PF,22,79,2676,619,1193,0.519,7,21,0.333,612,1172,0.522,0.522,261,340,0.768,230,489,719,234,121,28,218,242,1506,OOR,1984
Greg Kelser,SF,26,80,1783,313,603,0.519,2,6,0.333,311,597,0.521,0.521,250,356,0.702,188,203,391,91,68,31,195,249,878,OOR,1984
Albert King,SF,24,79,2103,465,946,0.492,3,22,0.136,462,924,0.5,0.493,232,295,0.786,125,263,388,203,91,33,208,258,1165,OOR,1984
Bernard King,SF,27,77,2667,795,1391,0.572,0,4,0.0,795,1387,0.573,0.572,437,561,0.779,123,271,394,164,75,17,197,273,2027,Candidate,1984
Reggie King,SF,26,77,2086,233,448,0.52,0,2,0.0,233,446,0.522,0.52,136,206,0.66,134,336,470,179,54,24,127,159,602,OOR,1984
Greg Kite,C,22,35,197,30,66,0.455,0,0,0.0,30,66,0.455,0.455,5,16,0.313,27,35,62,7,1,5,20,42,65,OOR,1984
Billy Knight,SF,31,75,1885,358,729,0.491,4,14,0.286,354,715,0.495,0.494,243,283,0.859,89,166,255,160,54,6,155,122,963,OOR,1984
Joe Kopicki,PF,23,59,678,64,132,0.485,1,7,0.143,63,125,0.504,0.489,91,112,0.813,64,102,166,46,15,5,39,71,220,OOR,1984
Bruce Kuczenski,PF,22,15,119,10,37,0.27,0,0,0.0,10,37,0.27,0.27,8,12,0.667,7,16,23,8,1,1,15,18,28,OOR,1984
Mitch Kupchak,PF,29,34,324,41,108,0.38,0,1,0.0,41,107,0.383,0.38,22,34,0.647,35,52,87,7,4,6,22,46,104,OOR,1984
Bill Laimbeer,C,26,82,2864,553,1044,0.53,0,11,0.0,553,1033,0.535,0.53,316,365,0.866,329,674,1003,149,49,84,151,273,1422,OOR,1984
Jeff Lamp,SF,24,64,660,128,261,0.49,2,13,0.154,126,248,0.508,0.494,60,67,0.896,23,40,63,51,22,4,52,67,318,OOR,1984
Mark Landsberger,PF,28,35,335,19,51,0.373,0,0,0.0,19,51,0.373,0.373,15,26,0.577,42,77,119,10,6,3,21,32,53,OOR,1984
Bob Lanier,C,35,72,2007,392,685,0.572,0,3,0.0,392,682,0.575,0.572,194,274,0.708,141,314,455,186,58,51,163,228,978,OOR,1984
Allen Leavell,PG,26,82,2009,349,731,0.477,11,71,0.155,338,660,0.512,0.485,238,286,0.832,31,86,117,459,107,12,184,199,947,OOR,1984
Ronnie Lester,PG,25,43,687,78,188,0.415,1,5,0.2,77,183,0.421,0.418,75,87,0.862,20,26,46,168,30,6,72,59,232,OOR,1984
Fat Lever,PG,23,81,2010,313,701,0.447,3,15,0.2,310,686,0.452,0.449,159,214,0.743,96,122,218,372,135,31,125,178,788,OOR,1984
Cliff Levingston,PF,23,80,1746,229,436,0.525,0,3,0.0,229,433,0.529,0.525,125,186,0.672,234,311,545,109,44,78,77,281,583,OOR,1984
Steve Lingenfelter,PF,25,3,14,1,1,1.0,0,0,0.0,1,1,1.0,1.0,0,2,0.0,3,1,4,1,0,0,1,6,2,OOR,1984
Alton Lister,PF,25,82,1955,256,512,0.5,0,0,0.0,256,512,0.5,0.5,114,182,0.626,156,447,603,110,41,140,153,327,626,OOR,1984
Lewis Lloyd,SG,24,82,2578,610,1182,0.516,3,13,0.231,607,1169,0.519,0.517,235,298,0.789,128,167,295,321,102,44,245,211,1458,OOR,1984
Darrell Lockhart,C,23,2,14,2,2,1.0,0,0,0.0,2,2,1.0,1.0,0,0,0.0,0,3,3,0,0,0,2,5,4,OOR,1984
Kevin Loder,SF,24,11,137,19,43,0.442,1,3,0.333,18,40,0.45,0.453,9,13,0.692,7,11,18,14,3,5,11,16,48,OOR,1984
John Long,SG,27,82,2514,545,1155,0.472,1,5,0.2,544,1150,0.473,0.472,243,275,0.884,139,150,289,205,93,18,143,199,1334,OOR,1984
Sidney Lowe,PG,24,78,1238,107,259,0.413,2,18,0.111,105,241,0.436,0.417,108,139,0.777,30,92,122,269,93,5,106,112,324,OOR,1984
John Lucas,PG,30,63,1807,275,595,0.462,19,69,0.275,256,526,0.487,0.478,120,157,0.764,23,157,180,673,92,5,147,123,689,OOR,1984
Maurice Lucas,PF,31,75,2309,451,908,0.497,0,5,0.0,451,903,0.499,0.497,293,383,0.765,208,517,725,203,55,39,177,235,1195,OOR,1984
Rudy Macklin,SF,25,8,65,12,30,0.4,0,0,0.0,12,30,0.4,0.4,11,13,0.846,5,6,11,3,1,0,6,17,35,OOR,1984
Kyle Macy,PG,26,82,2402,357,713,0.501,23,70,0.329,334,643,0.519,0.517,95,114,0.833,49,137,186,353,123,6,116,181,832,OOR,1984
Rick Mahorn,PF,25,82,2701,307,605,0.507,0,0,0.0,307,605,0.507,0.507,125,192,0.651,169,569,738,131,62,123,142,358,739,OOR,1984
Jeff Malone,SG,22,81,1976,408,918,0.444,24,74,0.324,384,844,0.455,0.458,142,172,0.826,57,98,155,151,23,13,110,162,982,OOR,1984
Moses Malone,C,28,71,2613,532,1101,0.483,0,4,0.0,532,1097,0.485,0.483,545,727,0.75,352,598,950,96,71,110,250,188,1609,OOR,1984
Pace Mannion,SF,23,57,469,50,126,0.397,3,13,0.231,47,113,0.416,0.409,18,23,0.783,23,36,59,47,25,2,23,63,121,OOR,1984
Wes Matthews,PG,24,20,388,61,131,0.466,1,8,0.125,60,123,0.488,0.469,27,36,0.75,7,20,27,83,16,3,40,45,150,OOR,1984
Cedric Maxwell,SF,28,80,2502,317,596,0.532,1,6,0.167,316,590,0.536,0.533,320,425,0.753,201,260,461,205,63,24,203,224,955,OOR,1984
Bob McAdoo,C,32,70,1456,352,748,0.471,0,5,0.0,352,743,0.474,0.471,212,264,0.803,82,207,289,74,42,50,127,182,916,OOR,1984
Rodney McCray,SF,22,79,2081,335,672,0.499,1,4,0.25,334,668,0.5,0.499,182,249,0.731,173,277,450,176,53,54,120,205,853,OOR,1984
Scooter McCray,PF,23,47,520,47,121,0.388,0,0,0.0,47,121,0.388,0.388,35,50,0.7,45,70,115,44,11,19,34,73,129,OOR,1984
Hank McDowell,PF,24,57,611,85,197,0.431,0,3,0.0,85,194,0.438,0.431,38,56,0.679,63,92,155,37,14,2,49,77,208,OOR,1984
Mike McGee,SF,24,77,1425,347,584,0.594,2,12,0.167,345,572,0.603,0.596,61,113,0.54,117,76,193,81,49,6,111,176,757,OOR,1984
Kevin McHale,PF,26,82,2577,587,1055,0.556,1,3,0.333,586,1052,0.557,0.557,336,439,0.765,208,402,610,104,23,126,150,243,1511,OOR,1984
Kevin McKenna,SG,25,61,923,152,371,0.41,3,17,0.176,149,354,0.421,0.414,80,98,0.816,30,65,95,114,46,5,62,133,387,OOR,1984
Billy McKinney,PG,28,80,843,136,305,0.446,0,2,0.0,136,303,0.449,0.446,39,46,0.848,7,47,54,161,27,0,48,84,311,OOR,1984
Tom McMillen,C,31,62,1294,222,447,0.497,1,6,0.167,221,441,0.501,0.498,127,156,0.814,64,135,199,73,14,17,70,162,572,OOR,1984
Mark McNamara,C,24,70,1037,157,253,0.621,0,0,0.0,157,253,0.621,0.621,74,157,0.471,137,180,317,31,14,12,89,138,388,OOR,1984
Joe Meriweather,C,30,73,1501,193,363,0.532,0,0,0.0,193,363,0.532,0.532,94,123,0.764,111,242,353,51,35,61,83,247,480,OOR,1984
Larry Micheaux,PF,23,39,332,49,90,0.544,0,0,0.0,49,90,0.544,0.544,21,39,0.538,40,73,113,19,21,11,21,46,119,OOR,1984
Bob Miller,PF,27,2,8,2,3,0.667,0,0,0.0,2,3,0.667,0.667,0,0,0.0,2,3,5,1,0,1,0,5,4,OOR,1984
Mike Mitchell,SF,28,79,2853,779,1597,0.488,6,14,0.429,773,1583,0.488,0.49,275,353,0.779,188,382,570,93,62,73,141,251,1839,OOR,1984
Paul Mokeski,C,27,68,838,102,213,0.479,1,3,0.333,101,210,0.481,0.481,50,72,0.694,51,115,166,44,11,29,44,168,255,OOR,1984
Sidney Moncrief,SG,26,79,3075,560,1125,0.498,5,18,0.278,555,1107,0.501,0.5,529,624,0.848,215,313,528,358,108,27,217,204,1654,OOR,1984
Johnny Moore,PG,25,59,1650,231,518,0.446,28,87,0.322,203,431,0.471,0.473,105,139,0.755,37,141,178,566,123,20,143,168,595,OOR,1984
Larry Nance,PF,24,82,2899,601,1044,0.576,0,7,0.0,601,1037,0.58,0.576,249,352,0.707,227,451,678,214,86,174,177,274,1451,OOR,1984
Swen Nater,C,34,69,829,124,253,0.49,0,1,0.0,124,252,0.492,0.49,63,91,0.692,81,183,264,27,25,7,68,150,311,OOR,1984
Calvin Natt,SF,27,79,2638,500,857,0.583,2,17,0.118,498,840,0.593,0.585,275,345,0.797,166,310,476,179,69,22,166,218,1277,OOR,1984
Ed Nealy,PF,23,71,960,63,126,0.5,0,0,0.0,63,126,0.5,0.5,48,60,0.8,73,149,222,50,41,9,33,138,174,OOR,1984
Kurt Nimphius,C,25,82,2284,272,523,0.52,1,4,0.25,271,519,0.522,0.521,101,162,0.623,182,331,513,176,41,144,98,283,646,OOR,1984
Norm Nixon,PG,28,82,3053,587,1270,0.462,11,46,0.239,576,1224,0.471,0.467,206,271,0.76,56,147,203,914,94,4,257,180,1391,OOR,1984
Audie Norris,C,23,79,1157,124,246,0.504,0,0,0.0,124,246,0.504,0.504,104,149,0.698,82,175,257,76,30,34,114,231,352,OOR,1984
Mike O'Koren,SF,25,73,1191,186,385,0.483,5,28,0.179,181,357,0.507,0.49,53,87,0.609,71,104,175,95,34,11,75,148,430,OOR,1984
Mark Olberding,PF,27,81,2160,249,504,0.494,0,1,0.0,249,503,0.495,0.494,261,318,0.821,119,326,445,192,50,28,166,291,759,OOR,1984
Jawann Oldham,C,26,64,870,110,218,0.505,0,0,0.0,110,218,0.505,0.505,39,66,0.591,75,158,233,33,15,76,83,139,259,OOR,1984
Louis Orr,SF,25,78,1640,262,572,0.458,0,0,0.0,262,572,0.458,0.458,173,211,0.82,101,127,228,61,66,17,95,142,697,OOR,1984
Robert Parish,C,30,80,2867,623,1140,0.546,0,0,0.0,623,1140,0.546,0.546,274,368,0.745,243,614,857,139,55,116,184,266,1520,OOR,1984
Billy Paultz,C,35,40,486,36,88,0.409,0,0,0.0,36,88,0.409,0.409,17,33,0.515,35,78,113,18,8,7,22,57,89,OOR,1984
Jim Paxson,SG,26,81,2686,680,1322,0.514,17,59,0.288,663,1263,0.525,0.521,345,410,0.841,68,105,173,251,122,10,142,165,1722,OOR,1984
John Paxson,PG,23,49,458,61,137,0.445,4,22,0.182,57,115,0.496,0.46,16,26,0.615,4,29,33,149,10,2,32,47,142,OOR,1984
Roger Phegley,SG,27,13,87,11,35,0.314,2,5,0.4,9,30,0.3,0.343,4,4,1.0,2,9,11,11,1,0,6,11,28,OOR,1984
Ricky Pierce,SG,24,69,1280,268,570,0.47,0,9,0.0,268,561,0.478,0.47,149,173,0.861,59,76,135,60,27,13,81,143,685,OOR,1984
John Pinone,SF,22,7,65,7,13,0.538,0,0,0.0,7,13,0.538,0.538,6,10,0.6,0,10,10,3,2,1,5,11,20,OOR,1984
Tom Piotrowski,C,23,18,78,12,26,0.462,0,0,0.0,12,26,0.462,0.462,6,6,1.0,6,10,16,5,1,3,6,22,30,OOR,1984
Charles Pittman,PF,25,69,989,126,209,0.603,0,2,0.0,126,207,0.609,0.603,69,101,0.683,76,138,214,70,16,22,81,129,321,OOR,1984
Ben Poquette,PF,28,51,858,75,171,0.439,1,5,0.2,74,166,0.446,0.442,34,43,0.791,57,125,182,49,20,33,28,114,185,OOR,1984
Paul Pressey,SG,25,81,1730,276,528,0.523,2,9,0.222,274,519,0.528,0.525,120,200,0.6,102,180,282,252,86,50,157,241,674,OOR,1984
Kurt Rambis,PF,25,47,743,63,113,0.558,0,0,0.0,63,113,0.558,0.558,42,66,0.636,82,184,266,34,30,14,56,108,168,OOR,1984
Kelvin Ransey,PG,25,80,1937,304,700,0.434,7,32,0.219,297,668,0.445,0.439,145,183,0.792,28,99,127,483,91,6,141,182,760,OOR,1984
Leo Rautins,SF,23,28,196,21,58,0.362,0,0,0.0,21,58,0.362,0.362,6,10,0.6,9,24,33,29,9,2,19,31,48,OOR,1984
Robert Reid,SF,28,64,1936,406,857,0.474,2,8,0.25,404,849,0.476,0.475,81,123,0.659,97,244,341,217,88,30,92,243,895,OOR,1984
Clint Richardson,SG,27,69,1571,221,473,0.467,0,4,0.0,221,469,0.471,0.467,79,103,0.767,62,103,165,155,49,23,100,145,521,OOR,1984
Micheal Ray Richardson,PG,28,48,1285,243,528,0.46,14,58,0.241,229,470,0.487,0.473,76,108,0.704,56,116,172,214,103,20,118,156,576,OOR,1984
Doc Rivers,PG,22,81,1938,250,541,0.462,2,12,0.167,248,529,0.469,0.464,255,325,0.785,72,148,220,314,127,30,174,286,757,OOR,1984
Anthony Roberts,SF,28,19,197,34,91,0.374,0,0,0.0,34,91,0.374,0.374,13,18,0.722,20,31,51,13,5,1,17,43,81,OOR,1984
Fred Roberts,PF,23,79,1531,214,399,0.536,1,4,0.25,213,395,0.539,0.538,144,172,0.837,102,202,304,98,52,38,100,219,573,OOR,1984
Rick Robey,C,28,61,856,140,257,0.545,1,1,1.0,139,256,0.543,0.547,61,88,0.693,80,118,198,65,20,14,77,120,342,OOR,1984
Cliff Robinson,C,23,73,2402,533,1185,0.45,1,2,0.5,532,1183,0.45,0.45,234,334,0.701,156,597,753,185,51,32,187,195,1301,OOR,1984
Truck Robinson,PF,32,65,2135,284,581,0.489,0,0,0.0,284,581,0.489,0.489,133,206,0.646,171,374,545,94,43,27,160,217,701,OOR,1984
Dave Robisch,C,34,31,340,35,96,0.365,0,0,0.0,35,96,0.365,0.365,22,26,0.846,15,43,58,20,3,2,12,36,92,OOR,1984
Tree Rollins,C,28,77,2351,274,529,0.518,0,0,0.0,274,529,0.518,0.518,118,190,0.621,200,393,593,62,35,277,101,297,666,OOR,1984
Lorenzo Romar,PG,25,68,1022,161,351,0.459,4,33,0.121,157,318,0.494,0.464,67,94,0.713,21,72,93,193,55,8,63,77,393,OOR,1984
Dan Roundfield,PF,30,73,2610,503,1038,0.485,0,11,0.0,503,1027,0.49,0.485,374,486,0.77,206,515,721,184,61,74,205,221,1380,OOR,1984
Jeff Ruland,C,25,75,3082,599,1035,0.579,1,7,0.143,598,1028,0.582,0.579,466,636,0.733,265,657,922,296,68,72,342,285,1665,OOR,1984
Walker Russell,PG,23,16,119,14,42,0.333,1,2,0.5,13,40,0.325,0.345,12,13,0.923,6,13,19,22,4,0,9,25,41,OOR,1984
Ralph Sampson,C,23,82,2693,716,1369,0.523,1,4,0.25,715,1365,0.524,0.523,287,434,0.661,293,620,913,163,70,197,294,339,1720,OOR,1984
Mike Sanders,SF,23,50,586,97,203,0.478,0,0,0.0,97,203,0.478,0.478,29,42,0.69,40,63,103,44,23,12,44,101,223,OOR,1984
DeWayne Scales,PF,25,2,13,3,5,0.6,0,0,0.0,3,5,0.6,0.6,0,2,0.0,0,3,3,0,1,0,2,1,6,OOR,1984
Danny Schayes,C,24,82,1420,183,371,0.493,0,2,0.0,183,369,0.496,0.493,215,272,0.79,145,288,433,91,32,60,119,308,581,OOR,1984
Alvin Scott,SF,28,65,735,55,124,0.444,1,2,0.5,54,122,0.443,0.448,56,72,0.778,29,71,100,48,19,20,42,85,167,OOR,1984
Byron Scott,SG,22,74,1637,334,690,0.484,8,34,0.235,326,656,0.497,0.49,112,139,0.806,50,114,164,177,81,19,116,174,788,OOR,1984
Lonnie Shelton,PF,28,79,2101,371,779,0.476,1,5,0.2,370,774,0.478,0.477,107,140,0.764,140,241,381,179,76,55,165,279,850,OOR,1984
Purvis Short,SF,26,79,2945,714,1509,0.473,22,72,0.306,692,1437,0.482,0.48,353,445,0.793,184,254,438,246,103,11,228,252,1803,OOR,1984
Jerry Sichting,PG,27,80,2497,397,746,0.532,6,20,0.3,391,726,0.539,0.536,117,135,0.867,44,127,171,457,90,8,144,179,917,OOR,1984
Jack Sikma,C,28,82,2993,576,1155,0.499,0,2,0.0,576,1153,0.5,0.499,411,480,0.856,225,686,911,327,95,92,236,301,1563,OOR,1984
Derek Smith,SG,22,61,1297,238,436,0.546,1,6,0.167,237,430,0.551,0.547,123,163,0.755,54,116,170,82,33,22,78,165,600,OOR,1984
Larry Smith,PF,26,75,2091,244,436,0.56,0,0,0.0,244,436,0.56,0.56,94,168,0.56,282,390,672,72,61,22,124,274,582,OOR,1984
Ricky Sobers,SG,31,81,2624,508,1115,0.456,29,111,0.261,479,1004,0.477,0.469,221,264,0.837,51,128,179,377,117,17,222,278,1266,OOR,1984
Jim Spanarkel,SG,26,7,54,7,16,0.438,1,2,0.5,6,14,0.429,0.469,9,13,0.692,5,2,7,5,6,0,4,8,24,OOR,1984
Rory Sparrow,PG,25,79,2436,350,738,0.474,10,39,0.256,340,699,0.486,0.481,108,131,0.824,48,141,189,539,100,8,210,230,818,OOR,1984
Larry Spriggs,SF,24,38,363,44,82,0.537,0,2,0.0,44,80,0.55,0.537,36,50,0.72,16,45,61,30,12,4,34,55,124,OOR,1984
Brook Steppe,SG,24,61,857,148,314,0.471,0,3,0.0,148,311,0.476,0.471,134,161,0.832,43,79,122,79,34,6,83,93,430,OOR,1984
Steve Stipanovich,C,23,81,2426,392,816,0.48,3,16,0.188,389,800,0.486,0.482,183,243,0.753,116,446,562,170,73,67,161,303,970,OOR,1984
Jon Sundvold,PG,22,73,1284,217,488,0.445,9,37,0.243,208,451,0.461,0.454,64,72,0.889,23,68,91,239,29,1,81,81,507,OOR,1984
Dane Suttle,SG,22,40,469,109,214,0.509,0,3,0.0,109,211,0.517,0.509,40,47,0.851,21,25,46,46,20,0,32,46,258,OOR,1984
Terry Teagle,SG,23,68,616,148,315,0.47,7,27,0.259,141,288,0.49,0.481,37,44,0.841,28,50,78,63,13,4,62,81,340,OOR,1984
Reggie Theus,PG,26,61,1498,262,625,0.419,7,42,0.167,255,583,0.437,0.425,214,281,0.762,50,79,129,352,50,12,156,171,745,OOR,1984
David Thirdkill,SF,23,46,291,31,72,0.431,0,1,0.0,31,71,0.437,0.431,15,31,0.484,9,22,31,27,10,3,19,44,77,OOR,1984
Isiah Thomas,PG,22,82,3007,669,1448,0.462,22,65,0.338,647,1383,0.468,0.47,388,529,0.733,103,224,327,914,204,33,307,324,1748,Candidate,1984
Jim Thomas,SG,23,72,1219,187,403,0.464,1,11,0.091,186,392,0.474,0.465,80,110,0.727,59,90,149,130,60,6,69,115,455,OOR,1984
David Thompson,SG,29,19,349,89,165,0.539,0,1,0.0,89,164,0.543,0.539,62,73,0.849,18,26,44,13,10,13,27,30,240,OOR,1984
LaSalle Thompson,C,22,80,1915,333,637,0.523,0,0,0.0,333,637,0.523,0.523,160,223,0.717,260,449,709,86,71,145,168,327,826,OOR,1984
Mychal Thompson,C,29,79,2648,487,929,0.524,0,2,0.0,487,927,0.525,0.524,266,399,0.667,235,453,688,308,84,108,235,237,1240,OOR,1984
Paul Thompson,SF,22,82,1731,309,662,0.467,9,39,0.231,300,623,0.482,0.474,115,149,0.772,120,192,312,122,70,37,73,192,742,OOR,1984
Sedale Threatt,PG,22,45,464,62,148,0.419,1,8,0.125,61,140,0.436,0.422,23,28,0.821,17,23,40,41,13,2,33,65,148,OOR,1984
Darren Tillis,C,23,72,730,108,254,0.425,0,2,0.0,108,252,0.429,0.425,41,63,0.651,75,109,184,24,12,60,51,176,257,OOR,1984
Ray Tolbert,PF,25,49,475,64,121,0.529,0,1,0.0,64,120,0.533,0.529,23,45,0.511,45,53,98,26,12,20,26,88,151,OOR,1984
Andrew Toney,SG,26,78,2556,593,1125,0.527,12,38,0.316,581,1087,0.534,0.532,390,465,0.839,57,136,193,373,70,23,297,251,1588,OOR,1984
Linton Townes,SF,24,4,19,4,8,0.5,0,0,0.0,4,8,0.5,0.5,0,0,0.0,0,1,1,1,1,2,1,4,8,OOR,1984
Kelly Tripucka,SF,24,76,2493,595,1296,0.459,2,17,0.118,593,1279,0.464,0.46,426,523,0.815,119,187,306,228,65,17,190,190,1618,OOR,1984
Trent Tucker,SG,24,63,1228,225,450,0.5,6,16,0.375,219,434,0.505,0.507,25,33,0.758,43,87,130,138,63,8,54,124,481,OOR,1984
Elston Turner,SF,24,47,536,54,150,0.36,1,9,0.111,53,141,0.376,0.363,28,34,0.824,42,51,93,59,26,0,29,40,137,OOR,1984
Terry Tyler,SF,27,82,1602,313,691,0.453,2,13,0.154,311,678,0.459,0.454,94,132,0.712,104,181,285,76,63,59,78,151,722,OOR,1984
Darnell Valentine,PG,24,68,1893,251,561,0.447,0,3,0.0,251,558,0.45,0.447,194,246,0.789,49,78,127,395,107,6,149,179,696,OOR,1984
Kiki Vandeweghe,PF,25,78,2734,895,1603,0.558,11,30,0.367,884,1573,0.562,0.562,494,580,0.852,84,289,373,238,53,50,156,187,2295,OOR,1984
Pete Verhoeven,PF,24,43,327,50,100,0.5,0,1,0.0,50,99,0.505,0.5,17,25,0.68,27,34,61,20,22,11,21,75,117,OOR,1984
Jay Vincent,SF,24,61,1421,252,579,0.435,0,1,0.0,252,578,0.436,0.435,168,215,0.781,81,166,247,114,30,10,113,159,672,OOR,1984
Danny Vranes,SF,25,80,2174,258,495,0.521,0,1,0.0,258,494,0.522,0.521,153,236,0.648,150,245,395,132,51,54,121,263,669,OOR,1984
Granville Waiters,C,23,78,1040,123,238,0.517,0,1,0.0,123,237,0.519,0.517,31,51,0.608,64,163,227,60,24,85,65,164,277,OOR,1984
Darrell Walker,PG,22,82,1324,216,518,0.417,4,15,0.267,212,503,0.421,0.421,208,263,0.791,74,93,167,284,127,15,194,202,644,OOR,1984
Foots Walker,PG,32,34,378,32,90,0.356,2,5,0.4,30,85,0.353,0.367,24,27,0.889,8,23,31,81,20,3,31,37,90,OOR,1984
Wally Walker,SF,29,58,612,118,241,0.49,2,6,0.333,116,235,0.494,0.494,6,18,0.333,26,66,92,55,17,4,33,65,244,OOR,1984
Bill Walton,C,31,55,1476,288,518,0.556,0,2,0.0,288,516,0.558,0.556,92,154,0.597,132,345,477,183,45,88,177,153,668,OOR,1984
Bryan Warrick,PG,24,32,254,27,66,0.409,1,3,0.333,26,63,0.413,0.417,8,16,0.5,5,17,22,43,9,3,20,37,63,OOR,1984
Marvin Webster,C,31,76,1290,112,239,0.469,0,0,0.0,112,239,0.469,0.469,66,117,0.564,146,220,366,53,34,100,85,187,290,OOR,1984
Scott Wedman,SF,31,68,916,148,333,0.444,2,13,0.154,146,320,0.456,0.447,29,35,0.829,41,98,139,67,27,7,43,107,327,OOR,1984
Brant Weidner,PF,23,8,38,2,9,0.222,0,0,0.0,2,9,0.222,0.222,4,4,1.0,4,7,11,0,0,2,2,5,8,OOR,1984
Mark West,C,23,34,202,15,42,0.357,0,0,0.0,15,42,0.357,0.357,7,22,0.318,19,27,46,13,1,15,12,55,37,OOR,1984
Paul Westphal,SG,33,59,865,144,313,0.46,7,26,0.269,137,287,0.477,0.471,117,142,0.824,8,35,43,148,41,6,77,69,412,OOR,1984
Ennis Whatley,PG,21,80,2159,261,556,0.469,0,2,0.0,261,554,0.471,0.469,146,200,0.73,63,134,197,662,119,17,268,223,668,OOR,1984
Rory White,SF,24,36,372,80,170,0.471,0,0,0.0,80,170,0.471,0.471,26,47,0.553,37,37,74,15,15,3,24,31,186,OOR,1984
Jerome Whitehead,C,27,70,921,144,294,0.49,0,0,0.0,144,294,0.49,0.49,88,107,0.822,94,151,245,19,17,12,59,159,376,OOR,1984
Mitchell Wiggins,SG,24,82,2123,399,890,0.448,7,29,0.241,392,861,0.455,0.452,213,287,0.742,138,190,328,187,106,11,139,278,1018,OOR,1984
Jamaal Wilkes,SF,30,75,2507,542,1055,0.514,2,8,0.25,540,1047,0.516,0.515,208,280,0.743,130,210,340,214,72,41,137,205,1294,OOR,1984
Dominique Wilkins,SF,24,81,2961,684,1429,0.479,0,11,0.0,684,1418,0.482,0.479,382,496,0.77,254,328,582,126,117,87,215,197,1750,OOR,1984
Jeff Wilkins,C,28,81,1734,249,520,0.479,0,3,0.0,249,517,0.482,0.479,134,182,0.736,109,346,455,73,27,42,109,205,632,OOR,1984
Buck Williams,PF,23,81,3003,495,926,0.535,0,4,0.0,495,922,0.537,0.535,284,498,0.57,355,645,1000,130,81,125,237,298,1274,OOR,1984
Gus Williams,PG,30,80,2818,598,1306,0.458,4,25,0.16,594,1281,0.464,0.459,297,396,0.75,67,137,204,675,189,25,232,151,1497,OOR,1984
Herb Williams,C,25,69,2279,411,860,0.478,0,4,0.0,411,856,0.48,0.478,207,295,0.702,154,400,554,215,60,108,207,193,1029,OOR,1984
Kevin Williams,SG,22,19,200,25,58,0.431,0,1,0.0,25,57,0.439,0.431,25,32,0.781,4,9,13,43,8,4,22,42,75,OOR,1984
Ray Williams,SG,29,76,2230,418,939,0.445,25,81,0.309,393,858,0.458,0.458,263,318,0.827,67,200,267,449,162,26,219,274,1124,OOR,1984
Rob Williams,PG,22,79,1924,309,671,0.461,15,47,0.319,294,624,0.471,0.472,171,209,0.818,54,140,194,464,84,5,169,268,804,OOR,1984
Sam Williams,PF,24,77,1434,204,431,0.473,0,1,0.0,204,430,0.474,0.473,92,140,0.657,121,218,339,62,68,106,99,209,500,OOR,1984
Sly Williams,SF,26,13,258,34,114,0.298,1,9,0.111,33,105,0.314,0.303,36,46,0.783,19,31,50,16,14,1,18,33,105,OOR,1984
Bill Willoughby,SF,26,67,936,124,258,0.481,0,7,0.0,124,251,0.494,0.481,55,63,0.873,75,118,193,56,23,24,53,106,303,OOR,1984
Michael Wilson,PG,24,6,26,0,2,0.0,0,1,0.0,0,1,0.0,0.0,1,2,0.5,1,0,1,3,0,0,3,5,1,OOR,1984
Randy Wittman,SG,24,78,1071,160,318,0.503,2,5,0.4,158,313,0.505,0.506,28,46,0.609,14,57,71,71,17,0,32,82,350,OOR,1984
Al Wood,SG,25,81,2236,467,945,0.494,3,21,0.143,464,924,0.502,0.496,223,271,0.823,94,181,275,166,64,32,126,207,1160,OOR,1984
Mike Woodson,SG,25,71,1838,389,816,0.477,2,8,0.25,387,808,0.479,0.478,247,302,0.818,62,113,175,175,83,28,115,174,1027,OOR,1984
Orlando Woolridge,SF,24,75,2544,570,1086,0.525,1,2,0.5,569,1084,0.525,0.525,303,424,0.715,130,239,369,136,71,60,188,253,1444,OOR,1984
James Worthy,PF,22,82,2415,495,890,0.556,0,6,0.0,495,884,0.56,0.556,195,257,0.759,157,358,515,207,77,70,181,244,1185,OOR,1984
