Player,Pos,Age,G,MP,FG,FGA,FG%,3P,3PA,3P%,2P,2PA,2P%,eFG%,FT,FTA,FT%,ORB,DRB,TRB,AST,STL,BLK,TOV,PF,PTS,Status
Alaa Abdelnaby,PF,22,43,290,55,116,0.474,0,0,0.0,55,116,0.474,0.474,25,44,0.568,27,62,89,12,4,12,22,39,135,OOR
Mahmoud Abdul-Rauf,PG,21,67,1505,417,1009,0.413,24,100,0.24,393,909,0.432,0.425,84,98,0.857,34,87,121,206,55,4,110,149,942,OOR
Mark Acres,C,28,68,1313,109,214,0.509,1,3,0.333,108,211,0.512,0.512,66,101,0.653,140,219,359,25,25,25,42,218,285,OOR
Michael Adams,PG,28,66,2346,560,1421,0.394,167,564,0.296,393,857,0.459,0.453,465,529,0.879,58,198,256,693,147,6,240,162,1752,OOR
Mark Aguirre,SF,31,78,2006,420,909,0.462,24,78,0.308,396,831,0.477,0.475,240,317,0.757,134,240,374,139,47,20,128,209,1104,OOR
Danny Ainge,SG,31,80,1710,337,714,0.472,102,251,0.406,235,463,0.508,0.543,114,138,0.826,45,160,205,285,63,13,100,195,890,OOR
Mark Alarie,PF,27,42,587,99,225,0.44,5,21,0.238,94,204,0.461,0.451,41,48,0.854,41,76,117,45,15,8,40,88,244,OOR
Steve Alford,PG,26,34,236,59,117,0.504,7,23,0.304,52,94,0.553,0.534,26,31,0.839,10,14,24,22,8,1,16,11,151,OOR
Greg Anderson,PF,26,68,924,116,270,0.43,0,1,0.0,116,269,0.431,0.43,60,115,0.522,97,221,318,16,35,45,84,140,292,OOR
Nick Anderson,SG,23,70,1971,400,857,0.467,17,58,0.293,383,799,0.479,0.477,173,259,0.668,92,294,386,106,74,44,113,145,990,OOR
Ron Anderson,SF,32,82,2340,512,1055,0.485,9,43,0.209,503,1012,0.497,0.49,165,198,0.833,103,264,367,115,65,13,100,163,1198,OOR
Willie Anderson,SG,24,75,2592,453,991,0.457,7,35,0.2,446,956,0.467,0.461,170,213,0.798,68,283,351,358,79,46,167,226,1083,OOR
Michael Ansley,SF,23,67,877,144,263,0.548,0,0,0.0,144,263,0.548,0.548,91,127,0.717,122,131,253,25,27,7,32,125,379,OOR
B.J. Armstrong,PG,23,82,1731,304,632,0.481,15,30,0.5,289,602,0.48,0.493,97,111,0.874,25,124,149,301,70,4,107,118,720,OOR
Vincent Askew,SG,24,7,85,12,25,0.48,0,0,0.0,12,25,0.48,0.48,9,11,0.818,7,4,11,13,2,0,6,21,33,OOR
Keith Askins,SF,23,39,266,34,81,0.42,6,25,0.24,28,56,0.5,0.457,12,25,0.48,30,38,68,19,16,13,11,46,86,OOR
Miloš Babić,PF,22,12,52,6,19,0.316,0,0,0.0,6,19,0.316,0.316,7,12,0.583,6,3,9,4,1,1,5,7,19,OOR
Thurl Bailey,PF,29,82,2486,399,872,0.458,0,3,0.0,399,869,0.459,0.458,219,271,0.808,101,306,407,124,53,91,130,160,1017,OOR
Cedric Ball,PF,22,7,26,3,8,0.375,0,0,0.0,3,8,0.375,0.375,2,2,1.0,5,6,11,0,0,2,2,5,8,OOR
Ken Bannister,PF,30,47,339,43,81,0.531,0,1,0.0,43,80,0.538,0.531,25,65,0.385,34,62,96,9,5,7,25,73,111,OOR
Charles Barkley,SF,27,67,2498,665,1167,0.57,44,155,0.284,621,1012,0.614,0.589,475,658,0.722,258,422,680,284,110,33,210,173,1849,Candidate
Dana Barros,PG,23,66,750,154,311,0.495,32,81,0.395,122,230,0.53,0.547,78,85,0.918,17,54,71,111,23,1,54,40,418,OOR
John Battle,SG,28,79,1863,397,862,0.461,14,49,0.286,383,813,0.471,0.469,270,316,0.854,34,125,159,217,45,6,113,145,1078,OOR
Kenny Battle,SG,26,56,945,133,282,0.472,3,24,0.125,130,258,0.504,0.477,70,93,0.753,83,93,176,62,60,18,53,108,339,OOR
William Bedford,C,27,60,562,106,242,0.438,5,13,0.385,101,229,0.441,0.448,55,78,0.705,55,76,131,32,2,36,32,76,272,OOR
Benoit Benjamin,C,26,70,2236,386,778,0.496,0,0,0.0,386,778,0.496,0.496,210,295,0.712,157,566,723,119,54,145,235,184,982,OOR
Winston Bennett,SF,25,27,334,40,107,0.374,0,0,0.0,40,107,0.374,0.374,35,47,0.745,30,34,64,28,8,2,20,50,115,OOR
Larry Bird,SF,34,60,2277,462,1017,0.454,77,198,0.389,385,819,0.47,0.492,163,183,0.891,53,456,509,431,108,58,187,118,1164,OOR
Rolando Blackman,SG,31,80,2965,634,1316,0.482,40,114,0.351,594,1202,0.494,0.497,282,326,0.865,63,193,256,301,69,19,159,153,1590,OOR
Lance Blanks,SG,24,38,214,26,61,0.426,2,16,0.125,24,45,0.533,0.443,10,14,0.714,4,16,20,26,9,2,18,35,64,OOR
Mookie Blaylock,PG,23,72,2585,432,1039,0.416,14,91,0.154,418,948,0.441,0.423,139,176,0.79,67,182,249,441,169,40,207,180,1017,OOR
Muggsy Bogues,PG,26,81,2299,241,524,0.46,0,12,0.0,241,512,0.471,0.46,86,108,0.796,58,158,216,669,137,3,120,160,568,OOR
Manute Bol,C,28,82,1522,65,164,0.396,1,14,0.071,64,150,0.427,0.399,24,41,0.585,66,284,350,20,16,247,63,184,155,OOR
Anthony Bonner,PF,22,34,750,103,230,0.448,0,0,0.0,103,230,0.448,0.448,44,76,0.579,59,102,161,49,39,5,41,62,250,OOR
Sam Bowie,C,29,62,1916,314,723,0.434,4,22,0.182,310,701,0.442,0.437,169,231,0.732,176,304,480,147,43,90,141,175,801,OOR
Randy Breuer,C,30,73,1505,197,435,0.453,0,0,0.0,197,435,0.453,0.453,35,79,0.443,114,231,345,73,35,80,69,132,429,OOR
Frank Brickowski,PF,31,75,1912,372,706,0.527,0,2,0.0,372,704,0.528,0.527,198,248,0.798,129,297,426,131,86,43,160,255,942,OOR
Scott Brooks,PG,25,80,980,159,370,0.43,45,135,0.333,114,235,0.485,0.491,61,72,0.847,28,44,72,204,53,5,51,122,424,OOR
Chucky Brown,SF,22,74,1485,263,502,0.524,0,4,0.0,263,498,0.528,0.524,101,144,0.701,78,135,213,80,26,24,94,130,627,OOR
Dee Brown,PG,22,82,1945,284,612,0.464,7,34,0.206,277,578,0.479,0.47,137,157,0.873,41,141,182,344,83,14,137,161,712,OOR
Mike Brown,C,27,82,1391,129,284,0.454,0,0,0.0,129,284,0.454,0.454,132,178,0.742,109,228,337,49,29,24,82,166,390,OOR
Tony Brown,SG-SF,30,30,294,30,80,0.375,3,12,0.25,27,68,0.397,0.394,20,23,0.87,24,19,43,16,4,0,16,47,83,OOR
Mark Bryant,PF,25,53,781,99,203,0.488,0,1,0.0,99,202,0.49,0.488,74,101,0.733,65,125,190,27,15,12,33,120,272,OOR
Jud Buechler,SF,22,74,859,94,226,0.416,1,4,0.25,93,222,0.419,0.418,43,66,0.652,61,80,141,51,33,15,26,79,232,OOR
Matt Bullard,PF,23,18,63,14,31,0.452,0,3,0.0,14,28,0.5,0.452,11,17,0.647,6,8,14,2,3,0,3,10,39,OOR
Willie Burton,SF,22,76,1928,341,773,0.441,4,30,0.133,337,743,0.454,0.444,229,293,0.782,111,151,262,107,72,24,144,275,915,OOR
Greg Butler,C,24,9,37,5,19,0.263,0,0,0.0,5,19,0.263,0.263,4,6,0.667,8,8,16,1,0,0,4,9,14,OOR
Michael Cage,C,29,82,2141,226,445,0.508,0,3,0.0,226,442,0.511,0.508,70,112,0.625,177,381,558,89,85,58,83,194,522,OOR
Adrian Caldwell,PF,24,42,343,35,83,0.422,0,1,0.0,35,82,0.427,0.422,7,17,0.412,43,57,100,8,19,10,30,35,77,OOR
Rick Calloway,SG,24,64,678,75,192,0.391,0,2,0.0,75,190,0.395,0.391,55,79,0.696,25,53,78,61,22,7,51,98,205,OOR
Elden Campbell,PF,22,52,380,56,123,0.455,0,0,0.0,56,123,0.455,0.455,32,49,0.653,40,56,96,10,11,38,16,71,144,OOR
Tony Campbell,SG,28,77,2893,652,1502,0.434,16,61,0.262,636,1441,0.441,0.439,358,446,0.803,161,185,346,214,121,48,190,204,1678,OOR
Antoine Carr,PF,29,77,2527,628,1228,0.511,0,3,0.0,628,1225,0.513,0.511,295,389,0.758,163,257,420,191,45,101,171,315,1551,OOR
Joe Barry Carroll,C,32,11,96,13,36,0.361,0,0,0.0,13,36,0.361,0.361,11,12,0.917,3,21,24,11,1,8,12,18,37,OOR
Bill Cartwright,C,33,79,2273,318,649,0.49,0,0,0.0,318,649,0.49,0.49,124,178,0.697,167,319,486,126,32,15,113,167,760,OOR
Terry Catledge,PF,27,51,1459,292,632,0.462,0,5,0.0,292,627,0.466,0.462,161,258,0.624,168,187,355,58,34,9,107,113,745,OOR
Duane Causwell,C,22,76,1719,210,413,0.508,0,0,0.0,210,413,0.508,0.508,105,165,0.636,141,250,391,69,49,148,96,225,525,OOR
Cedric Ceballos,SF,21,63,730,204,419,0.487,1,6,0.167,203,413,0.492,0.488,110,166,0.663,77,73,150,35,22,5,69,70,519,OOR
Tom Chambers,PF,31,76,2475,556,1271,0.437,20,73,0.274,536,1198,0.447,0.445,379,459,0.826,104,386,490,194,65,52,177,235,1511,OOR
Rex Chapman,PG,23,70,2100,410,922,0.445,48,148,0.324,362,774,0.468,0.471,234,282,0.83,45,146,191,250,73,16,131,167,1102,OOR
Maurice Cheeks,PG,34,76,2147,241,483,0.499,5,20,0.25,236,463,0.51,0.504,105,129,0.814,22,151,173,435,128,10,108,138,592,OOR
Derrick Chievous,SF,23,18,110,17,46,0.37,0,0,0.0,17,46,0.37,0.37,9,16,0.563,11,7,18,2,3,1,6,16,43,OOR
Richard Coffey,SF,25,52,320,28,75,0.373,0,1,0.0,28,74,0.378,0.373,12,22,0.545,42,37,79,3,6,4,5,45,68,OOR
Derrick Coleman,PF,23,74,2602,514,1100,0.467,13,38,0.342,501,1062,0.472,0.473,323,442,0.731,269,490,759,163,71,99,217,217,1364,OOR
Bimbo Coles,PG,22,82,1355,162,393,0.412,6,34,0.176,156,359,0.435,0.42,71,95,0.747,56,97,153,232,65,12,98,149,401,OOR
Steve Colter,PG,28,19,251,23,56,0.411,5,14,0.357,18,42,0.429,0.455,7,10,0.7,5,21,26,37,11,1,11,27,58,OOR
Lester Conner,PG,31,74,1008,96,207,0.464,0,5,0.0,96,202,0.475,0.464,68,94,0.723,21,91,112,165,85,2,58,75,260,OOR
Anthony Cook,PF,23,58,1121,118,283,0.417,0,3,0.0,118,280,0.421,0.417,71,129,0.55,134,192,326,26,35,72,50,100,307,OOR
Wayne Cooper,C,34,67,746,57,145,0.393,0,1,0.0,57,144,0.396,0.393,33,42,0.786,54,134,188,22,7,61,22,120,147,OOR
Tyrone Corbin,SF,28,82,3196,587,1311,0.448,2,10,0.2,585,1301,0.45,0.449,296,371,0.798,185,404,589,347,162,53,209,257,1472,OOR
Dave Corzine,C,34,28,147,17,38,0.447,0,0,0.0,17,38,0.447,0.447,13,22,0.591,10,23,33,4,5,5,2,18,47,OOR
Pat Cummings,PF,34,4,26,4,6,0.667,0,0,0.0,4,6,0.667,0.667,7,10,0.7,3,2,5,0,0,0,2,8,15,OOR
Terry Cummings,PF,29,67,2195,503,1039,0.484,7,33,0.212,496,1006,0.493,0.487,164,240,0.683,194,327,521,157,61,30,131,225,1177,OOR
Earl Cureton,PF,33,9,159,8,24,0.333,0,1,0.0,8,23,0.348,0.333,1,3,0.333,6,30,36,3,0,3,6,16,17,OOR
Dell Curry,SG,26,76,1515,337,715,0.471,32,86,0.372,305,629,0.485,0.494,96,114,0.842,47,152,199,166,75,25,80,125,802,OOR
Quintin Dailey,SG,30,30,299,73,155,0.471,0,1,0.0,73,154,0.474,0.471,38,62,0.613,11,21,32,16,7,1,19,25,184,OOR
Adrian Dantley,SF,35,10,126,19,50,0.38,1,3,0.333,18,47,0.383,0.39,18,26,0.692,8,5,13,9,5,0,6,8,57,OOR
Brad Daugherty,C,25,76,2946,605,1155,0.524,0,3,0.0,605,1152,0.525,0.524,435,579,0.751,177,653,830,253,74,46,211,191,1645,OOR
Brad Davis,PG,35,80,1426,159,373,0.426,22,85,0.259,137,288,0.476,0.456,91,118,0.771,13,105,118,230,45,17,77,212,431,OOR
Terry Davis,PF,23,55,996,115,236,0.487,1,2,0.5,114,234,0.487,0.489,69,124,0.556,107,159,266,39,18,28,36,129,300,OOR
Walter Davis,SG,36,71,1483,403,862,0.468,11,36,0.306,392,826,0.475,0.474,107,117,0.915,71,110,181,125,80,3,88,150,924,OOR
Johnny Dawkins,PG,27,4,124,26,41,0.634,1,4,0.25,25,37,0.676,0.646,10,11,0.909,0,16,16,28,3,0,8,4,63,OOR
Tony Dawson,SF,23,4,17,4,7,0.571,1,1,1.0,3,6,0.5,0.643,0,0,0.0,2,0,2,0,0,0,1,0,9,OOR
Byron Dinkins,PG,23,12,149,14,34,0.412,0,0,0.0,14,34,0.412,0.412,8,9,0.889,0,12,12,19,2,0,13,15,36,OOR
Vlade Divac,C,22,82,2310,360,637,0.565,5,14,0.357,355,623,0.57,0.569,196,279,0.703,205,461,666,92,106,127,146,247,921,OOR
James Donaldson,C,33,82,2800,327,615,0.532,0,0,0.0,327,615,0.532,0.532,165,229,0.721,201,526,727,69,34,93,146,181,819,OOR
Sherman Douglas,PG,24,73,2562,532,1055,0.504,4,31,0.129,528,1024,0.516,0.506,284,414,0.686,78,131,209,624,121,5,270,178,1352,OOR
Greg Dreiling,C,28,73,1031,98,194,0.505,0,2,0.0,98,192,0.51,0.505,63,105,0.6,66,189,255,51,24,29,57,178,259,OOR
Larry Drew,PG,32,48,496,54,125,0.432,14,33,0.424,40,92,0.435,0.488,17,22,0.773,5,29,34,118,15,1,49,40,139,OOR
Clyde Drexler,SG,28,82,2852,645,1338,0.482,61,191,0.319,584,1147,0.509,0.505,416,524,0.794,212,334,546,493,144,60,232,226,1767,OOR
Kevin Duckworth,C,26,81,2511,521,1084,0.481,0,2,0.0,521,1082,0.482,0.481,240,311,0.772,177,354,531,89,33,34,186,251,1282,OOR
Chris Dudley,C,25,61,1560,170,417,0.408,0,0,0.0,170,417,0.408,0.408,94,176,0.534,229,282,511,37,39,153,80,217,434,OOR
Joe Dumars,SG,27,80,3046,622,1292,0.481,14,45,0.311,608,1247,0.488,0.487,371,417,0.89,62,125,187,443,89,7,189,135,1629,OOR
T.R. Dunn,SG,35,17,217,21,47,0.447,1,4,0.25,20,43,0.465,0.457,9,10,0.9,20,22,42,24,12,1,7,30,52,OOR
Ledell Eackles,SG,24,67,1616,345,762,0.453,14,59,0.237,331,703,0.471,0.462,164,222,0.739,47,81,128,136,47,10,115,121,868,OOR
Mark Eaton,C,34,80,2580,169,292,0.579,0,0,0.0,169,292,0.579,0.579,71,112,0.634,182,485,667,51,39,188,99,298,409,OOR
Blue Edwards,SF,25,62,1611,244,464,0.526,6,24,0.25,238,440,0.541,0.532,82,117,0.701,51,150,201,108,57,29,105,203,576,OOR
James Edwards,C,35,72,1903,383,792,0.484,1,2,0.5,382,790,0.484,0.484,215,295,0.729,91,186,277,65,12,30,126,249,982,OOR
Kevin Edwards,SG,25,79,2000,380,927,0.41,24,84,0.286,356,843,0.422,0.423,171,213,0.803,80,125,205,240,129,46,163,151,955,OOR
Craig Ehlo,SG,29,82,2766,344,773,0.445,49,149,0.329,295,624,0.473,0.477,95,140,0.679,142,246,388,376,121,34,160,209,832,OOR
Mario Elie,SF-SG,27,33,644,79,159,0.497,4,10,0.4,75,149,0.503,0.509,75,89,0.843,46,64,110,45,19,10,30,85,237,OOR
Sean Elliott,SF,22,82,3044,478,976,0.49,20,64,0.313,458,912,0.502,0.5,325,402,0.808,142,314,456,238,69,33,147,190,1301,OOR
Dale Ellis,SG,30,51,1424,340,718,0.474,57,157,0.363,283,561,0.504,0.513,120,166,0.723,66,107,173,95,49,8,81,112,857,OOR
Pervis Ellison,C,23,76,1942,326,636,0.513,0,6,0.0,326,630,0.517,0.513,139,214,0.65,224,361,585,102,49,157,146,268,791,OOR
A.J. English,SG,23,70,1443,251,572,0.439,3,31,0.097,248,541,0.458,0.441,111,157,0.707,66,81,147,177,25,15,114,127,616,OOR
Alex English,SF,37,79,1748,322,734,0.439,0,1,0.0,322,733,0.439,0.439,119,140,0.85,108,146,254,105,40,25,101,141,763,OOR
Patrick Ewing,C,28,81,3104,845,1645,0.514,0,6,0.0,845,1639,0.516,0.514,464,623,0.745,194,711,905,244,80,258,291,287,2154,OOR
Jim Farmer,SG,26,27,456,101,223,0.453,5,23,0.217,96,200,0.48,0.464,48,65,0.738,29,39,68,38,13,2,38,58,255,OOR
Dave Feitl,C,28,52,372,52,140,0.371,0,3,0.0,52,137,0.38,0.371,33,44,0.75,29,71,100,8,3,12,25,52,137,OOR
Duane Ferrell,SF,25,78,1165,174,356,0.489,2,3,0.667,172,353,0.487,0.492,125,156,0.801,97,82,179,55,33,27,78,151,475,OOR
Danny Ferry,PF,24,81,1661,275,643,0.428,23,77,0.299,252,566,0.445,0.446,124,152,0.816,99,187,286,142,43,25,120,230,697,OOR
Vern Fleming,PG,28,69,1929,356,671,0.531,4,18,0.222,352,653,0.539,0.534,161,221,0.729,83,131,214,369,76,13,137,116,877,OOR
Sleepy Floyd,PG,30,82,1850,386,939,0.411,48,176,0.273,338,763,0.443,0.437,185,246,0.752,52,107,159,317,95,17,140,122,1005,OOR
Greg Foster,PF,22,54,606,97,211,0.46,0,5,0.0,97,206,0.471,0.46,42,61,0.689,52,99,151,37,12,22,45,112,236,OOR
Anthony Frederick,SF,26,35,475,67,168,0.399,0,0,0.0,67,168,0.399,0.399,43,60,0.717,36,48,84,44,22,13,40,50,177,OOR
Corey Gaines,SG,25,10,226,28,70,0.4,5,21,0.238,23,49,0.469,0.436,22,26,0.846,4,10,14,91,10,2,23,25,83,OOR
Kevin Gamble,SF,25,82,2706,548,933,0.587,0,7,0.0,548,926,0.592,0.587,185,227,0.815,85,182,267,256,100,34,148,237,1281,OOR
Winston Garland,PG,26,69,1702,221,519,0.426,4,26,0.154,217,493,0.44,0.43,118,157,0.752,46,152,198,317,97,10,116,189,564,OOR
Tom Garrick,SG,24,67,949,100,236,0.424,0,22,0.0,100,214,0.467,0.424,60,79,0.759,40,87,127,223,62,2,66,101,260,OOR
Kenny Gattison,PF,26,72,1552,243,457,0.532,0,2,0.0,243,455,0.534,0.532,164,248,0.661,136,243,379,44,48,67,102,211,650,OOR
Tate George,PG,22,56,594,80,193,0.415,0,2,0.0,80,191,0.419,0.415,32,40,0.8,19,28,47,104,25,5,42,58,192,OOR
Derrick Gervin,PF,27,56,743,164,394,0.416,7,28,0.25,157,366,0.429,0.425,90,114,0.789,40,70,110,30,19,19,45,88,425,OOR
Kendall Gill,SG,22,82,1944,376,836,0.45,2,14,0.143,374,822,0.455,0.451,152,182,0.835,105,158,263,303,104,39,163,186,906,OOR
Armen Gilliam,PF,26,75,2644,487,1001,0.487,0,2,0.0,487,999,0.487,0.487,268,329,0.815,220,378,598,105,69,53,174,185,1242,OOR
Gerald Glass,SF,23,51,606,149,340,0.438,2,17,0.118,147,323,0.455,0.441,52,76,0.684,54,48,102,42,28,9,41,76,352,OOR
Mike Gminski,C,31,80,2196,357,808,0.442,2,14,0.143,355,794,0.447,0.443,128,158,0.81,186,396,582,93,40,56,85,99,844,OOR
Dan Godfread,C,23,10,20,5,12,0.417,0,1,0.0,5,11,0.455,0.417,3,4,0.75,0,2,2,0,1,4,0,5,13,OOR
Jim Grandholm,PF,30,26,168,30,58,0.517,9,17,0.529,21,41,0.512,0.595,10,21,0.476,20,30,50,8,2,8,11,33,79,OOR
Gary Grant,PG,25,68,2105,265,587,0.451,9,39,0.231,256,548,0.467,0.459,51,74,0.689,69,140,209,587,103,12,210,192,590,OOR
Greg Grant,PG,24,22,107,10,27,0.37,1,3,0.333,9,24,0.375,0.389,5,6,0.833,1,9,10,20,9,0,10,12,26,OOR
Harvey Grant,PF,25,77,2842,609,1224,0.498,2,15,0.133,607,1209,0.502,0.498,185,249,0.743,179,378,557,204,91,61,125,232,1405,OOR
Horace Grant,PF,25,78,2641,401,733,0.547,1,6,0.167,400,727,0.55,0.548,197,277,0.711,266,393,659,178,95,69,92,203,1000,OOR
Stuart Gray,C,27,8,37,4,12,0.333,0,0,0.0,4,12,0.333,0.333,3,3,1.0,2,8,10,0,0,1,2,6,11,OOR
Jeff Grayer,SG,25,82,1422,210,485,0.433,0,3,0.0,210,482,0.436,0.433,101,147,0.687,111,135,246,123,48,9,86,98,521,OOR
A.C. Green,PF,27,82,2164,258,542,0.476,11,55,0.2,247,487,0.507,0.486,223,302,0.738,201,315,516,71,59,23,99,117,750,OOR
Rickey Green,PG,36,79,2248,334,722,0.463,8,36,0.222,326,686,0.475,0.468,117,141,0.83,33,104,137,413,57,6,108,130,793,OOR
Sidney Green,PF,30,66,1099,177,384,0.461,0,3,0.0,177,381,0.465,0.461,89,105,0.848,98,215,313,52,32,13,89,172,443,OOR
Dave Greenwood,PF,33,63,1018,85,169,0.503,0,2,0.0,85,167,0.509,0.503,69,94,0.734,61,160,221,52,29,25,71,172,239,OOR
Darrell Griffith,SG,32,75,1005,174,445,0.391,48,138,0.348,126,307,0.41,0.445,34,45,0.756,17,73,90,37,42,7,48,100,430,OOR
Scott Haffner,PG,24,7,50,8,21,0.381,0,2,0.0,8,19,0.421,0.381,1,2,0.5,2,2,4,9,3,1,4,4,17,OOR
Jack Haley,PF,27,78,1178,161,343,0.469,0,0,0.0,161,343,0.469,0.469,112,181,0.619,140,216,356,31,20,21,63,199,434,OOR
Tom Hammonds,PF,23,70,1023,155,336,0.461,0,4,0.0,155,332,0.467,0.461,57,79,0.722,58,148,206,43,15,7,54,108,367,OOR
Bob Hansen,SG,30,36,811,96,256,0.375,19,69,0.275,77,187,0.412,0.412,18,36,0.5,33,63,96,90,20,5,34,72,229,OOR
Tim Hardaway,PG,24,82,3215,739,1551,0.476,97,252,0.385,642,1299,0.494,0.508,306,381,0.803,87,245,332,793,214,12,270,228,1881,OOR
Derek Harper,PG,29,77,2879,572,1226,0.467,89,246,0.362,483,980,0.493,0.503,286,391,0.731,59,174,233,548,147,14,177,222,1519,OOR
Ron Harper,SG,27,39,1383,285,729,0.391,48,148,0.324,237,581,0.408,0.424,145,217,0.668,58,130,188,209,66,35,129,111,763,OOR
Tony Harris,SG,23,6,41,4,16,0.25,0,2,0.0,4,14,0.286,0.25,2,4,0.5,0,1,1,0,1,0,3,5,10,OOR
Scott Hastings,PF,30,27,113,16,28,0.571,3,4,0.75,13,24,0.542,0.625,13,13,1.0,14,14,28,7,0,0,7,23,48,OOR
Hersey Hawkins,SG,24,80,3110,590,1251,0.472,108,270,0.4,482,981,0.491,0.515,479,550,0.871,48,262,310,299,178,39,213,182,1767,OOR
Gerald Henderson,PG,35,23,392,50,117,0.427,7,21,0.333,43,96,0.448,0.457,16,21,0.762,8,29,37,62,12,2,28,43,123,OOR
Steve Henson,PG,22,68,690,79,189,0.418,18,54,0.333,61,135,0.452,0.466,38,42,0.905,14,37,51,131,32,0,43,83,214,OOR
Mike Higgins,SF,23,7,61,6,10,0.6,0,0,0.0,6,10,0.6,0.6,4,7,0.571,4,1,5,2,0,2,4,16,16,OOR
Rod Higgins,SF,31,82,2024,259,559,0.463,73,220,0.332,186,339,0.549,0.529,185,226,0.819,109,245,354,113,52,37,65,198,776,OOR
Sean Higgins,SF,22,50,464,97,212,0.458,3,19,0.158,94,193,0.487,0.465,28,33,0.848,18,45,63,35,8,1,49,53,225,OOR
Tyrone Hill,PF,22,74,1192,147,299,0.492,0,0,0.0,147,299,0.492,0.492,96,152,0.632,157,226,383,19,33,30,72,264,390,OOR
Roy Hinson,PF,29,9,91,20,39,0.513,0,0,0.0,20,39,0.513,0.513,1,3,0.333,6,13,19,4,0,3,6,14,41,OOR
Craig Hodges,SG,30,73,843,146,344,0.424,44,115,0.383,102,229,0.445,0.488,26,27,0.963,10,32,42,97,34,2,35,74,362,OOR
Dave Hoppen,C,26,30,155,24,44,0.545,0,2,0.0,24,42,0.571,0.545,16,22,0.727,18,21,39,3,3,1,13,29,64,OOR
Dennis Hopson,SF,25,61,728,104,244,0.426,1,5,0.2,103,239,0.431,0.428,55,83,0.663,49,60,109,65,25,14,59,79,264,OOR
Jeff Hornacek,SG,27,80,2733,544,1051,0.518,61,146,0.418,483,905,0.534,0.547,201,224,0.897,74,247,321,409,111,16,130,185,1350,OOR
Jay Humphries,PG,28,80,2726,482,960,0.502,60,161,0.373,422,799,0.528,0.533,191,239,0.799,57,163,220,538,129,7,151,237,1215,OOR
Byron Irvin,SG,24,33,316,60,129,0.465,1,5,0.2,59,124,0.476,0.469,50,61,0.82,24,21,45,24,15,2,16,32,171,OOR
Mark Jackson,PG,25,72,1595,250,508,0.492,13,51,0.255,237,457,0.519,0.505,117,160,0.731,62,135,197,452,60,9,135,81,630,OOR
Dave Jamerson,SG,23,37,202,43,113,0.381,5,19,0.263,38,94,0.404,0.403,22,27,0.815,9,21,30,27,6,1,20,24,113,OOR
Henry James,PF,25,37,505,112,254,0.441,24,60,0.4,88,194,0.454,0.488,52,72,0.722,26,53,79,32,15,5,37,59,300,OOR
Les Jepsen,C,23,21,105,11,36,0.306,0,1,0.0,11,35,0.314,0.306,6,9,0.667,17,20,37,1,1,3,3,16,28,OOR
Avery Johnson,PG,25,68,959,130,277,0.469,1,9,0.111,129,268,0.481,0.471,59,87,0.678,22,55,77,230,47,4,74,62,320,OOR
Buck Johnson,SF,27,73,2279,416,873,0.477,2,15,0.133,414,858,0.483,0.478,157,216,0.727,108,222,330,142,81,47,122,240,991,OOR
Eddie Johnson,SG,31,81,2085,543,1122,0.484,39,120,0.325,504,1002,0.503,0.501,229,257,0.891,107,164,271,111,58,9,122,181,1354,OOR
Kevin Johnson,PG,24,77,2772,591,1145,0.516,9,44,0.205,582,1101,0.529,0.52,519,616,0.843,54,217,271,781,163,11,269,174,1710,OOR
Magic Johnson,PG,31,79,2933,466,976,0.477,80,250,0.32,386,726,0.532,0.518,519,573,0.906,105,446,551,989,102,17,314,150,1531,Candidate
Steve Johnson,C,33,24,228,34,63,0.54,0,0,0.0,34,63,0.54,0.54,22,37,0.595,18,39,57,17,4,4,25,50,90,OOR
Vinnie Johnson,SG,34,82,2390,406,936,0.434,11,34,0.324,395,902,0.438,0.44,135,209,0.646,110,170,280,271,75,15,118,166,958,OOR
Charles Jones,C,33,62,1499,67,124,0.54,0,0,0.0,67,124,0.54,0.54,29,50,0.58,119,240,359,48,51,124,46,199,163,OOR
Michael Jordan,SG,27,82,3034,990,1837,0.539,29,93,0.312,961,1744,0.551,0.547,571,671,0.851,118,374,492,453,223,83,202,229,2580,MVP
Shawn Kemp,PF,21,81,2442,462,909,0.508,2,12,0.167,460,897,0.513,0.509,288,436,0.661,267,412,679,144,77,123,202,319,1214,OOR
Steve Kerr,PG,25,57,905,99,223,0.444,28,62,0.452,71,161,0.441,0.507,45,53,0.849,5,32,37,131,29,4,40,52,271,OOR
Jerome Kersey,SF,28,73,2359,424,887,0.478,4,13,0.308,420,874,0.481,0.48,232,327,0.709,169,312,481,227,101,76,149,251,1084,OOR
Alec Kessler,C,24,78,1259,199,468,0.425,0,4,0.0,199,464,0.429,0.425,88,131,0.672,115,221,336,31,17,26,108,189,486,OOR
Randolph Keys,SF,24,44,473,59,145,0.407,3,14,0.214,56,131,0.427,0.417,19,33,0.576,40,60,100,18,22,15,35,93,140,OOR
Bo Kimble,SG,24,62,1004,159,418,0.38,19,65,0.292,140,353,0.397,0.403,92,119,0.773,42,77,119,76,30,8,77,158,429,OOR
Bernard King,SF,34,64,2401,713,1511,0.472,8,37,0.216,705,1474,0.478,0.475,383,485,0.79,114,205,319,292,56,16,255,187,1817,OOR
Stacey King,PF,24,76,1198,156,334,0.467,0,2,0.0,156,332,0.47,0.467,107,152,0.704,72,136,208,65,24,42,91,134,419,OOR
Greg Kite,C,29,82,2225,166,338,0.491,0,0,0.0,166,338,0.491,0.491,63,123,0.512,189,399,588,59,25,81,102,298,395,OOR
Joe Kleine,C,29,72,850,102,218,0.468,0,2,0.0,102,216,0.472,0.468,54,69,0.783,71,173,244,21,15,14,53,108,258,OOR
Negele Knight,PG,23,64,792,131,308,0.425,6,25,0.24,125,283,0.442,0.435,71,118,0.602,20,51,71,191,20,7,76,83,339,OOR
Bart Kofoed,SG,26,5,21,0,3,0.0,0,0,0.0,0,3,0.0,0.0,3,6,0.5,2,1,3,4,0,0,2,4,3,OOR
Jon Koncak,C,27,77,1931,140,321,0.436,1,8,0.125,139,313,0.444,0.438,32,54,0.593,101,274,375,124,74,76,50,265,313,OOR
Frank Kornet,PF,24,32,157,23,62,0.371,5,18,0.278,18,44,0.409,0.411,7,13,0.538,10,14,24,9,5,1,11,28,58,OOR
Bill Laimbeer,C,33,82,2668,372,778,0.478,37,125,0.296,335,653,0.513,0.502,123,147,0.837,173,564,737,157,38,56,98,242,904,OOR
Jerome Lane,PF,24,62,1383,202,461,0.438,1,4,0.25,201,457,0.44,0.439,58,141,0.411,280,298,578,123,51,14,105,192,463,OOR
Andrew Lang,C,24,63,1152,109,189,0.577,0,1,0.0,109,188,0.58,0.577,93,130,0.715,113,190,303,27,17,127,45,168,311,OOR
Eric Leckner,C,24,72,1122,131,294,0.446,0,0,0.0,131,294,0.446,0.446,62,111,0.559,82,213,295,39,14,22,69,192,324,OOR
Kurk Lee,PG,23,48,265,19,71,0.268,3,15,0.2,16,56,0.286,0.289,25,28,0.893,7,23,30,34,11,2,20,39,66,OOR
Tim Legler,SG,24,10,148,25,72,0.347,3,12,0.25,22,60,0.367,0.368,5,6,0.833,8,10,18,12,2,0,4,20,58,OOR
Gary Leonard,C,23,4,9,0,0,0.0,0,0,0.0,0,0,0.0,0.0,2,4,0.5,0,2,2,0,0,1,0,2,2,OOR
Jim Les,PG,27,55,1399,119,268,0.444,71,154,0.461,48,114,0.421,0.576,86,103,0.835,18,93,111,299,57,4,75,141,395,OOR
Clifford Lett,PG,25,7,99,14,29,0.483,0,1,0.0,14,28,0.5,0.483,6,9,0.667,1,6,7,7,2,1,8,9,34,OOR
Fat Lever,SG,30,4,86,9,23,0.391,0,3,0.0,9,20,0.45,0.391,11,14,0.786,3,12,15,12,6,3,10,5,29,OOR
Cliff Levingston,PF,30,78,1013,127,282,0.45,1,4,0.25,126,278,0.453,0.452,59,91,0.648,99,126,225,56,29,43,50,143,314,OOR
Reggie Lewis,SG,25,79,2878,598,1219,0.491,1,13,0.077,597,1206,0.495,0.491,281,340,0.826,119,291,410,201,98,85,147,234,1478,OOR
Marcus Liberty,SF,22,76,1171,216,513,0.421,17,57,0.298,199,456,0.436,0.438,58,92,0.63,117,104,221,64,48,19,71,153,507,OOR
Todd Lichti,SG,24,29,860,166,378,0.439,14,47,0.298,152,331,0.459,0.458,59,69,0.855,49,63,112,72,46,8,33,65,405,OOR
Alton Lister,C,32,77,1552,188,393,0.478,0,1,0.0,188,392,0.48,0.478,115,202,0.569,121,362,483,93,20,90,106,282,491,OOR
Ian Lockhart,SF,23,1,2,1,1,1.0,0,0,0.0,1,1,1.0,1.0,2,2,1.0,0,0,0,0,0,0,0,0,4,OOR
Brad Lohaus,PF,26,81,1219,179,415,0.431,33,119,0.277,146,296,0.493,0.471,37,54,0.685,59,158,217,75,50,74,60,170,428,OOR
Grant Long,PF,24,80,2514,276,561,0.492,1,6,0.167,275,555,0.495,0.493,181,230,0.787,225,343,568,176,119,43,156,295,734,OOR
John Long,SG,34,25,256,35,85,0.412,2,6,0.333,33,79,0.418,0.424,24,25,0.96,9,23,32,18,9,2,14,17,96,OOR
Rick Mahorn,C,32,80,2439,261,559,0.467,0,9,0.0,261,550,0.475,0.467,189,240,0.788,151,470,621,118,79,56,127,276,711,OOR
Dan Majerle,SF,25,77,2281,397,821,0.484,30,86,0.349,367,735,0.499,0.502,227,298,0.762,168,250,418,216,106,40,114,162,1051,OOR
Jeff Malone,SG,29,69,2466,525,1034,0.508,1,6,0.167,524,1028,0.51,0.508,231,252,0.917,36,170,206,143,50,6,108,128,1282,OOR
Karl Malone,PF,27,82,3302,847,1608,0.527,4,14,0.286,843,1594,0.529,0.528,684,888,0.77,236,731,967,270,89,79,244,268,2382,Candidate
Moses Malone,C,35,82,1912,280,598,0.468,0,7,0.0,280,591,0.474,0.468,309,372,0.831,271,396,667,68,30,74,137,134,869,OOR
Danny Manning,PF,24,73,2197,470,905,0.519,0,3,0.0,470,902,0.521,0.519,219,306,0.716,169,257,426,196,117,62,188,281,1159,OOR
Šarūnas Marčiulionis,SG,26,50,987,183,365,0.501,1,6,0.167,182,359,0.507,0.503,178,246,0.724,51,67,118,85,62,4,75,136,545,OOR
Jeff Martin,PG,24,74,1334,214,507,0.422,27,88,0.307,187,419,0.446,0.449,68,100,0.68,53,78,131,65,37,31,49,104,523,OOR
Anthony Mason,PF,24,3,21,2,4,0.5,0,0,0.0,2,4,0.5,0.5,6,8,0.75,3,2,5,0,1,0,0,6,10,OOR
Tony Massenburg,PF,23,35,161,27,60,0.45,0,0,0.0,27,60,0.45,0.45,28,45,0.622,23,35,58,4,4,9,13,26,82,OOR
Vernon Maxwell,SG,25,82,2870,504,1247,0.404,172,510,0.337,332,737,0.45,0.473,217,296,0.733,41,197,238,303,127,15,171,179,1397,OOR
Travis Mays,PG,22,64,2145,294,724,0.406,72,197,0.365,222,527,0.421,0.456,255,331,0.77,54,124,178,253,81,11,159,169,915,OOR
George McCloud,SF,23,74,1070,131,351,0.373,43,124,0.347,88,227,0.388,0.434,38,49,0.776,35,83,118,150,40,11,91,141,343,OOR
Tim McCormick,C,28,56,689,93,187,0.497,0,3,0.0,93,184,0.505,0.497,66,90,0.733,56,109,165,32,11,14,45,91,252,OOR
Rodney McCray,PF,29,74,2561,336,679,0.495,13,39,0.333,323,640,0.505,0.504,159,198,0.803,153,407,560,259,70,51,129,203,844,OOR
Xavier McDaniel,SF,27,81,2634,590,1186,0.497,0,8,0.0,590,1178,0.501,0.497,193,267,0.723,173,384,557,187,76,46,184,264,1373,OOR
Kevin McHale,PF,33,68,2067,504,912,0.553,15,37,0.405,489,875,0.559,0.561,228,275,0.829,145,335,480,126,25,146,140,194,1251,OOR
Derrick McKey,SF,24,73,2503,438,847,0.517,4,19,0.211,434,828,0.524,0.519,235,278,0.845,172,251,423,169,91,56,158,220,1115,OOR
Nate McMillan,SG,26,78,1434,132,305,0.433,17,48,0.354,115,257,0.447,0.461,57,93,0.613,71,180,251,371,104,20,122,211,338,OOR
Mark McNamara,C,31,2,13,0,1,0.0,0,0,0.0,0,1,0.0,0.0,0,0,0.0,0,4,4,0,0,0,0,1,0,OOR
Scott Meents,PF,27,13,53,7,28,0.25,1,1,1.0,6,27,0.222,0.268,2,4,0.5,3,7,10,8,7,4,6,5,17,OOR
Reggie Miller,SG,25,82,2972,596,1164,0.512,112,322,0.348,484,842,0.575,0.56,551,600,0.918,81,200,281,331,109,13,163,165,1855,OOR
Terry Mills,PF,23,55,819,134,288,0.465,0,4,0.0,134,284,0.472,0.465,47,66,0.712,82,147,229,33,35,29,43,100,315,OOR
Sam Mitchell,PF,27,82,3121,445,1010,0.441,0,9,0.0,445,1001,0.445,0.441,307,396,0.775,188,332,520,133,66,57,104,338,1197,OOR
Paul Mokeski,C,34,36,257,21,59,0.356,3,9,0.333,18,50,0.36,0.381,12,15,0.8,20,47,67,9,8,3,7,58,57,OOR
Sidney Moncrief,SG,33,72,1096,117,240,0.488,21,64,0.328,96,176,0.545,0.531,82,105,0.781,31,97,128,104,50,9,66,112,337,OOR
Chris Morris,SF,25,79,2553,409,962,0.425,45,179,0.251,364,783,0.465,0.449,179,244,0.734,210,311,521,220,138,96,167,248,1042,OOR
John Morton,SF,23,66,1207,120,274,0.438,4,12,0.333,116,262,0.443,0.445,113,139,0.813,41,62,103,243,61,18,107,112,357,OOR
Chris Mullin,SF,27,82,3315,777,1449,0.536,40,133,0.301,737,1316,0.56,0.55,513,580,0.884,141,302,443,329,173,63,245,176,2107,OOR
Chris Munk,PF,23,11,29,3,7,0.429,0,0,0.0,3,7,0.429,0.429,7,12,0.583,5,9,14,1,1,2,5,5,13,OOR
Tod Murphy,PF,27,52,1063,90,227,0.396,1,17,0.059,89,210,0.424,0.399,70,105,0.667,92,163,255,60,25,20,32,101,251,OOR
Jerrod Mustaf,PF,21,62,825,106,228,0.465,0,1,0.0,106,227,0.467,0.465,56,87,0.644,51,118,169,36,15,14,61,109,268,OOR
Pete Myers,SG,27,8,103,10,23,0.435,0,1,0.0,10,22,0.455,0.435,9,11,0.818,2,16,18,14,3,3,14,14,29,OOR
Larry Nance,PF,31,80,2927,635,1211,0.524,2,8,0.25,633,1203,0.526,0.525,265,330,0.803,201,485,686,237,66,200,131,219,1537,OOR
Craig Neal,PG,26,10,125,14,35,0.4,3,9,0.333,11,26,0.423,0.443,13,22,0.591,2,14,16,37,4,0,19,26,44,OOR
Ed Nealy,PF,30,55,573,45,97,0.464,5,16,0.313,40,81,0.494,0.49,28,38,0.737,44,107,151,36,24,4,19,46,123,OOR
Johnny Newman,SF,27,81,2477,478,1017,0.47,30,84,0.357,448,933,0.48,0.485,385,476,0.809,94,160,254,188,100,17,189,278,1371,OOR
Ken Norman,SF,26,70,2309,520,1037,0.501,6,32,0.188,514,1005,0.511,0.504,173,275,0.629,177,320,497,159,63,63,139,192,1219,OOR
Dan O'Sullivan,C,22,21,85,7,16,0.438,0,0,0.0,7,16,0.438,0.438,7,11,0.636,5,12,17,4,1,1,4,18,21,OOR
Charles Oakley,PF,27,76,2739,307,595,0.516,0,2,0.0,307,593,0.518,0.516,239,305,0.784,305,615,920,204,62,17,215,288,853,OOR
Alan Ogg,C,23,31,261,24,55,0.436,0,2,0.0,24,53,0.453,0.436,6,10,0.6,15,34,49,2,6,27,8,53,54,OOR
Hakeem Olajuwon,C,28,56,2062,487,959,0.508,0,4,0.0,487,955,0.51,0.508,213,277,0.769,219,551,770,131,121,221,174,221,1187,OOR
Jawann Oldham,C,33,4,19,3,6,0.5,0,0,0.0,3,6,0.5,0.5,0,0,0.0,0,3,3,0,0,0,0,1,6,OOR
Brian Oliver,SG,22,73,800,111,272,0.408,5,18,0.278,106,254,0.417,0.417,52,71,0.732,18,62,80,88,34,4,50,76,279,OOR
Gerald Paddio,SF,25,70,1181,212,506,0.419,6,24,0.25,206,482,0.427,0.425,74,93,0.796,38,80,118,90,20,6,71,71,504,OOR
Walter Palmer,C,22,28,85,15,45,0.333,0,1,0.0,15,44,0.341,0.333,10,15,0.667,6,15,21,6,3,4,6,20,40,OOR
Robert Parish,C,37,81,2441,485,811,0.598,0,1,0.0,485,810,0.599,0.598,237,309,0.767,271,585,856,66,66,103,153,197,1207,OOR
John Paxson,PG,30,82,1971,317,578,0.548,42,96,0.438,275,482,0.571,0.585,34,41,0.829,15,76,91,297,62,3,69,136,710,OOR
Kenny Payne,SF,24,47,444,68,189,0.36,4,18,0.222,64,171,0.374,0.37,26,29,0.897,17,49,66,16,10,6,21,43,166,OOR
Gary Payton,PG,22,82,2244,259,575,0.45,1,13,0.077,258,562,0.459,0.451,69,97,0.711,108,135,243,528,165,15,180,249,588,OOR
Will Perdue,C,25,74,972,116,235,0.494,0,3,0.0,116,232,0.5,0.494,75,112,0.67,122,214,336,47,23,57,75,147,307,OOR
Sam Perkins,PF,29,73,2504,368,744,0.495,18,64,0.281,350,680,0.515,0.507,229,279,0.821,167,371,538,108,64,78,103,247,983,OOR
Tim Perry,C,25,46,587,75,144,0.521,0,5,0.0,75,139,0.54,0.521,43,70,0.614,53,73,126,27,23,43,32,60,193,OOR
Chuck Person,SF,26,80,2566,620,1231,0.504,69,203,0.34,551,1028,0.536,0.532,165,229,0.721,121,296,417,238,56,17,184,221,1474,OOR
Jim Petersen,C,28,62,834,114,236,0.483,1,4,0.25,113,232,0.487,0.485,50,76,0.658,69,131,200,27,13,41,48,153,279,OOR
Dražen Petrović,SG,26,61,1015,243,493,0.493,23,65,0.354,220,428,0.514,0.516,114,137,0.832,51,59,110,86,43,1,81,132,623,OOR
Ricky Pierce,SG,31,78,2167,561,1156,0.485,46,116,0.397,515,1040,0.495,0.505,430,471,0.913,67,124,191,168,60,13,147,170,1598,OOR
Ed Pinckney,PF,27,70,1165,131,243,0.539,0,1,0.0,131,242,0.541,0.539,104,116,0.897,155,186,341,45,61,43,45,147,366,OOR
Scottie Pippen,SF,25,82,3014,600,1153,0.52,21,68,0.309,579,1085,0.534,0.529,240,340,0.706,163,432,595,511,193,93,232,270,1461,OOR
Olden Polynice,C,26,79,2092,316,564,0.56,0,1,0.0,316,563,0.561,0.56,146,252,0.579,220,333,553,42,43,32,88,192,778,OOR
Dave Popson,PF,26,19,64,13,32,0.406,0,0,0.0,13,32,0.406,0.406,9,10,0.9,7,7,14,2,1,2,6,12,35,OOR
Terry Porter,PG,27,81,2665,486,944,0.515,130,313,0.415,356,631,0.564,0.584,279,339,0.823,52,230,282,649,158,12,189,151,1381,OOR
Paul Pressey,SG,32,70,1683,201,426,0.472,16,57,0.281,185,369,0.501,0.491,110,133,0.827,50,126,176,271,63,32,130,174,528,OOR
Mark Price,PG,26,16,571,97,195,0.497,18,53,0.34,79,142,0.556,0.544,59,62,0.952,8,37,45,166,42,2,56,23,271,OOR
Kevin Pritchard,PG,23,62,773,88,229,0.384,5,31,0.161,83,198,0.419,0.395,62,77,0.805,16,49,65,81,30,8,59,104,243,OOR
Brian Quinnett,SG,24,68,1011,139,303,0.459,15,43,0.349,124,260,0.477,0.483,26,36,0.722,65,80,145,53,22,13,52,100,319,OOR
Kurt Rambis,PF,32,62,900,83,167,0.497,0,2,0.0,83,165,0.503,0.497,60,85,0.706,77,189,266,64,25,11,45,107,226,OOR
Blair Rasmussen,C,28,70,2325,405,885,0.458,2,5,0.4,403,880,0.458,0.459,63,93,0.677,170,508,678,70,52,132,81,307,875,OOR
J.R. Reid,C,22,80,2467,360,773,0.466,0,2,0.0,360,771,0.467,0.466,182,259,0.703,154,348,502,89,87,47,153,286,902,OOR
Robert Reid,SF,35,3,37,2,14,0.143,0,0,0.0,2,14,0.143,0.143,0,0,0.0,2,7,9,4,1,3,3,3,4,OOR
Jerry Reynolds,SG,28,80,1843,344,793,0.434,10,34,0.294,334,759,0.44,0.44,336,419,0.802,88,211,299,203,95,56,172,123,1034,OOR
Glen Rice,SF,23,77,2646,550,1193,0.461,71,184,0.386,479,1009,0.475,0.491,171,209,0.818,85,296,381,189,101,26,166,216,1342,OOR
Pooh Richardson,PG,24,82,3154,635,1350,0.47,42,128,0.328,593,1222,0.485,0.486,89,165,0.539,82,204,286,734,131,13,174,114,1401,OOR
Mitch Richmond,SG,25,77,3027,703,1424,0.494,40,115,0.348,663,1309,0.506,0.508,394,465,0.847,147,305,452,238,126,34,230,207,1840,OOR
Doc Rivers,PG,29,79,2586,444,1020,0.435,88,262,0.336,356,758,0.47,0.478,221,262,0.844,47,206,253,340,148,47,125,216,1197,OOR
Fred Roberts,PF,30,82,2114,357,670,0.533,4,25,0.16,353,645,0.547,0.536,170,209,0.813,107,174,281,135,63,29,135,190,888,OOR
Alvin Robertson,SG,28,81,2598,438,904,0.485,23,63,0.365,415,841,0.493,0.497,199,263,0.757,191,268,459,444,246,16,212,273,1098,OOR
Clifford Robinson,PF,24,82,1940,373,806,0.463,6,19,0.316,367,787,0.466,0.467,205,314,0.653,123,226,349,151,78,76,133,263,957,OOR
David Robinson,C,25,82,3095,754,1366,0.552,1,7,0.143,753,1359,0.554,0.552,592,777,0.762,335,728,1063,208,127,320,270,264,2101,Candidate
Larry Robinson,SG,23,36,425,62,150,0.413,0,1,0.0,62,149,0.416,0.413,15,27,0.556,29,22,51,35,16,1,27,49,139,OOR
Rumeal Robinson,PG,24,47,674,108,242,0.446,2,11,0.182,106,231,0.459,0.45,47,80,0.588,20,51,71,132,32,8,76,65,265,OOR
Dennis Rodman,SF,29,82,2747,276,560,0.493,6,30,0.2,270,530,0.509,0.498,111,176,0.631,361,665,1026,85,65,55,94,281,669,OOR
Tree Rollins,C,35,37,202,14,33,0.424,0,0,0.0,14,33,0.424,0.424,8,14,0.571,13,29,42,4,2,20,15,35,36,OOR
Delaney Rudd,PG,28,82,874,124,285,0.435,17,61,0.279,107,224,0.478,0.465,59,71,0.831,14,52,66,216,36,2,102,92,324,OOR
John Salley,PF,26,74,1649,179,377,0.475,0,1,0.0,179,376,0.476,0.475,186,256,0.727,137,190,327,70,52,112,91,240,544,OOR
Ralph Sampson,C,30,25,348,34,93,0.366,1,5,0.2,33,88,0.375,0.371,5,19,0.263,41,70,111,17,11,17,27,54,74,OOR
Jeff Sanders,PF,25,3,43,6,14,0.429,0,0,0.0,6,14,0.429,0.429,1,2,0.5,3,6,9,1,1,1,1,6,13,OOR
Mike Sanders,SF,30,80,1357,206,494,0.417,4,20,0.2,202,474,0.426,0.421,47,57,0.825,73,112,185,106,37,26,65,198,463,OOR
Danny Schayes,C,31,82,2228,298,597,0.499,0,5,0.0,298,592,0.503,0.499,274,328,0.835,174,361,535,98,55,61,106,264,870,OOR
Steve Scheffler,C,23,39,227,20,39,0.513,0,0,0.0,20,39,0.513,0.513,19,21,0.905,21,24,45,9,6,2,4,20,59,OOR
Dwayne Schintzius,C,22,42,398,68,155,0.439,0,2,0.0,68,153,0.444,0.439,22,40,0.55,28,93,121,17,2,29,34,64,158,OOR
Detlef Schrempf,PF,28,82,2632,432,831,0.52,15,40,0.375,417,791,0.527,0.529,441,539,0.818,178,482,660,301,58,22,175,262,1320,OOR
Byron Scott,SG,29,82,2630,501,1051,0.477,71,219,0.324,430,832,0.517,0.51,118,148,0.797,54,192,246,177,95,21,85,146,1191,OOR
Dennis Scott,SG,22,82,2336,503,1183,0.425,125,334,0.374,378,849,0.445,0.478,153,204,0.75,62,173,235,134,62,25,127,203,1284,OOR
Rony Seikaly,C,25,64,2171,395,822,0.481,2,6,0.333,393,816,0.482,0.482,258,417,0.619,207,502,709,95,51,86,205,213,1050,OOR
John Shasky,C,26,57,510,51,116,0.44,0,0,0.0,51,116,0.44,0.44,48,79,0.608,58,76,134,11,14,20,27,75,150,OOR
Brian Shaw,PG,24,79,2772,442,942,0.469,3,27,0.111,439,915,0.48,0.471,204,249,0.819,104,266,370,602,105,34,223,206,1091,OOR
Jack Sikma,C,35,77,1940,295,691,0.427,46,135,0.341,249,556,0.448,0.46,166,197,0.843,108,333,441,143,65,64,130,218,802,OOR
Lionel Simmons,SF,22,79,2978,549,1301,0.422,3,11,0.273,546,1290,0.423,0.423,320,435,0.736,193,504,697,315,113,85,230,249,1421,OOR
Scott Skiles,PG,26,79,2714,462,1039,0.445,93,228,0.408,369,811,0.455,0.489,340,377,0.902,57,213,270,660,89,4,252,192,1357,OOR
Charles Smith,SF,25,74,2703,548,1168,0.469,0,7,0.0,548,1161,0.472,0.469,384,484,0.793,216,392,608,134,81,145,165,267,1480,OOR
Charles Smith,PG,23,5,30,3,7,0.429,0,0,0.0,3,7,0.429,0.429,3,5,0.6,0,2,2,6,1,0,3,7,9,OOR
Clinton Smith,SG,27,5,45,2,4,0.5,0,0,0.0,2,4,0.5,0.5,3,6,0.5,2,2,4,4,1,0,1,3,7,OOR
Derek Smith,SF,29,2,16,1,4,0.25,0,1,0.0,1,3,0.333,0.25,3,4,0.75,0,0,0,5,1,1,1,3,5,OOR
Kenny Smith,PG,25,78,2699,522,1003,0.52,49,135,0.363,473,868,0.545,0.545,287,340,0.844,36,127,163,554,106,11,237,131,1380,OOR
Larry Smith,PF,33,81,1923,128,263,0.487,0,0,0.0,128,263,0.487,0.487,12,50,0.24,302,407,709,88,83,22,93,265,268,OOR
Michael Smith,PF,25,47,389,95,200,0.475,6,24,0.25,89,176,0.506,0.49,22,27,0.815,21,35,56,43,6,2,37,27,218,OOR
Otis Smith,SF,27,75,1885,407,902,0.451,9,46,0.196,398,856,0.465,0.456,221,301,0.734,176,213,389,169,85,35,140,190,1044,OOR
Tony Smith,SG,22,64,695,97,220,0.441,0,7,0.0,97,213,0.455,0.441,40,57,0.702,24,47,71,135,28,12,69,80,234,OOR
Rik Smits,C,24,76,1690,342,705,0.485,0,0,0.0,342,705,0.485,0.485,144,189,0.762,116,241,357,84,24,111,86,246,828,OOR
Mike Smrek,C,28,15,95,9,27,0.333,0,0,0.0,9,27,0.333,0.333,6,12,0.5,7,19,26,4,3,3,3,27,24,OOR
Rory Sparrow,PG,32,80,2375,371,756,0.491,31,78,0.397,340,678,0.501,0.511,58,83,0.699,45,141,186,362,83,16,126,189,831,OOR
Felton Spencer,C,23,81,2099,195,381,0.512,0,1,0.0,195,380,0.513,0.512,182,252,0.722,272,369,641,25,48,121,77,337,572,OOR
John Starks,SG,25,61,1173,180,410,0.439,27,93,0.29,153,317,0.483,0.472,79,105,0.752,30,101,131,204,59,17,74,137,466,OOR
Everette Stephens,PG,24,3,6,2,3,0.667,0,0,0.0,2,3,0.667,0.667,2,2,1.0,0,0,0,2,0,0,0,0,6,OOR
John Stockton,PG,28,82,3103,496,978,0.507,58,168,0.345,438,810,0.541,0.537,363,434,0.836,46,191,237,1164,234,16,298,233,1413,OOR
Rod Strickland,PG,24,58,2076,314,651,0.482,11,33,0.333,303,618,0.49,0.491,161,211,0.763,57,162,219,463,117,11,156,125,800,OOR
Jon Sundvold,SG,29,24,225,43,107,0.402,15,35,0.429,28,72,0.389,0.472,11,11,1.0,3,6,9,24,7,0,16,11,112,OOR
Roy Tarpley,C,26,5,171,43,79,0.544,0,1,0.0,43,78,0.551,0.544,16,18,0.889,16,39,55,12,6,9,13,20,102,OOR
Terry Teagle,SG,30,82,1498,335,757,0.443,0,9,0.0,335,748,0.448,0.443,145,177,0.819,82,99,181,82,31,8,83,165,815,OOR
Reggie Theus,SG,33,81,2955,583,1247,0.468,52,144,0.361,531,1103,0.481,0.488,292,343,0.851,69,160,229,378,85,35,252,231,1510,OOR
Irving Thomas,PF,25,26,108,17,50,0.34,0,0,0.0,17,50,0.34,0.34,12,21,0.571,14,17,31,10,4,1,13,24,46,OOR
Isiah Thomas,PG,29,48,1657,289,665,0.435,19,65,0.292,270,600,0.45,0.449,179,229,0.782,35,125,160,446,75,10,185,118,776,OOR
Jim Thomas,SG,30,3,14,1,4,0.25,0,0,0.0,1,4,0.25,0.25,0,0,0.0,0,0,0,1,1,0,1,0,2,OOR
Billy Thompson,SF,27,73,1481,205,411,0.499,0,4,0.0,205,407,0.504,0.499,89,124,0.718,120,192,312,111,32,48,117,161,499,OOR
LaSalle Thompson,C,29,82,1946,276,565,0.488,1,5,0.2,275,560,0.491,0.489,72,104,0.692,154,409,563,147,63,63,168,265,625,OOR
Mychal Thompson,C,36,72,1077,113,228,0.496,0,2,0.0,113,226,0.5,0.496,62,88,0.705,74,154,228,21,23,23,47,112,288,OOR
Bob Thornton,PF,28,12,110,4,13,0.308,0,0,0.0,4,13,0.308,0.308,8,10,0.8,1,14,15,1,0,3,9,18,16,OOR
Otis Thorpe,PF,28,82,3039,549,988,0.556,3,7,0.429,546,981,0.557,0.557,334,480,0.696,287,559,846,197,73,20,217,278,1435,OOR
Sedale Threatt,PG,29,80,2066,433,835,0.519,10,35,0.286,423,800,0.529,0.525,137,173,0.792,25,74,99,273,113,8,138,191,1013,OOR
Wayman Tisdale,PF,26,33,1116,262,542,0.483,0,1,0.0,262,541,0.484,0.483,136,170,0.8,75,178,253,66,23,28,82,99,660,OOR
Tom Tolbert,PF,25,62,1371,183,433,0.423,7,21,0.333,176,412,0.427,0.431,127,172,0.738,87,188,275,76,35,38,80,195,500,OOR
Andy Toolson,SF,25,47,470,50,124,0.403,12,32,0.375,38,92,0.413,0.452,25,33,0.758,32,35,67,31,14,2,24,58,137,OOR
Kelly Tripucka,SF,31,77,1289,187,412,0.454,15,45,0.333,172,367,0.469,0.472,152,167,0.91,46,130,176,159,33,13,92,130,541,OOR
Trent Tucker,SG,31,65,1194,191,434,0.44,64,153,0.418,127,281,0.452,0.514,17,27,0.63,33,72,105,111,44,9,46,120,463,OOR
Andre Turner,PG,26,70,1407,168,383,0.439,12,33,0.364,156,350,0.446,0.454,64,87,0.736,36,116,152,311,63,0,95,124,412,OOR
Jeff Turner,PF,28,71,1683,259,532,0.487,6,15,0.4,253,517,0.489,0.492,85,112,0.759,108,255,363,97,29,10,126,234,609,OOR
Kelvin Upshaw,SG,28,48,514,104,231,0.45,7,29,0.241,97,202,0.48,0.465,55,64,0.859,20,35,55,86,28,5,39,77,270,OOR
Darnell Valentine,PG,31,65,1841,230,496,0.464,6,25,0.24,224,471,0.476,0.47,143,172,0.831,37,135,172,351,98,12,126,170,609,OOR
Kiki Vandeweghe,SF,32,75,2420,458,927,0.494,51,141,0.362,407,786,0.518,0.522,259,288,0.899,78,102,180,110,42,10,108,122,1226,OOR
Loy Vaught,PF,22,73,1178,175,359,0.487,0,2,0.0,175,357,0.49,0.487,49,74,0.662,124,225,349,40,20,23,49,135,399,OOR
Sam Vincent,PG,27,49,975,152,353,0.431,3,19,0.158,149,334,0.446,0.435,99,120,0.825,17,90,107,197,30,5,91,74,406,OOR
Stojko Vranković,C,27,31,166,24,52,0.462,0,0,0.0,24,52,0.462,0.462,10,18,0.556,15,36,51,4,1,29,24,43,58,OOR
Milt Wagner,SG,27,13,116,24,57,0.421,6,17,0.353,18,40,0.45,0.474,9,11,0.818,0,7,7,15,2,3,12,14,63,OOR
Darrell Walker,PG,29,71,2305,230,535,0.43,0,9,0.0,230,526,0.437,0.43,93,154,0.604,140,358,498,459,78,33,154,199,553,OOR
Kenny Walker,SF,26,54,771,83,191,0.435,0,1,0.0,83,190,0.437,0.435,64,82,0.78,63,94,157,13,18,30,30,92,230,OOR
Spud Webb,PG,27,75,2197,359,803,0.447,54,168,0.321,305,635,0.48,0.481,231,266,0.868,41,133,174,417,118,6,146,180,1003,OOR
Bill Wennington,C,27,77,1455,181,415,0.436,1,5,0.2,180,410,0.439,0.437,74,94,0.787,101,239,340,69,46,59,51,230,437,OOR
Doug West,SG,23,75,824,118,246,0.48,0,1,0.0,118,245,0.482,0.48,58,84,0.69,56,80,136,48,35,23,41,115,294,OOR
Mark West,C,30,82,1957,247,382,0.647,0,0,0.0,247,382,0.647,0.647,135,206,0.655,171,393,564,37,32,161,86,266,629,OOR
Randy White,PF,23,79,1901,265,665,0.398,6,37,0.162,259,628,0.412,0.403,159,225,0.707,173,331,504,63,81,44,131,308,695,OOR
Morlon Wiley,PG,24,34,350,45,108,0.417,6,12,0.5,39,96,0.406,0.444,17,25,0.68,4,13,17,73,24,0,34,37,113,OOR
Dominique Wilkins,SF,31,81,3078,770,1640,0.47,85,249,0.341,685,1391,0.492,0.495,476,574,0.829,261,471,732,265,123,65,201,156,2101,OOR
Eddie Lee Wilkins,C,28,68,668,114,255,0.447,0,1,0.0,114,254,0.449,0.447,51,90,0.567,69,111,180,15,17,7,50,91,279,OOR
Gerald Wilkins,SG,27,68,2164,380,804,0.473,9,43,0.209,371,761,0.488,0.478,169,206,0.82,78,129,207,275,82,23,161,181,938,OOR
Buck Williams,PF,30,80,2582,358,595,0.602,0,0,0.0,358,595,0.602,0.602,217,308,0.705,227,524,751,97,47,47,137,247,933,OOR
Herb Williams,C,32,60,1832,332,655,0.507,0,4,0.0,332,651,0.51,0.507,83,130,0.638,86,271,357,95,30,88,113,197,747,OOR
Hot Rod Williams,C,28,43,1293,199,430,0.463,0,1,0.0,199,429,0.464,0.463,107,164,0.652,111,179,290,100,36,69,63,126,505,OOR
Jayson Williams,PF,22,52,508,72,161,0.447,1,2,0.5,71,159,0.447,0.45,37,56,0.661,41,70,111,16,9,6,40,92,182,OOR
John Williams,SF,24,33,941,164,393,0.417,10,41,0.244,154,352,0.438,0.43,73,97,0.753,42,135,177,133,39,6,68,63,411,OOR
Kenny Williams,PF,21,75,527,93,179,0.52,0,3,0.0,93,176,0.528,0.52,34,50,0.68,56,75,131,31,11,31,41,81,220,OOR
Micheal Williams,PG,24,73,1706,261,523,0.499,1,7,0.143,260,516,0.504,0.5,290,330,0.879,49,127,176,348,150,17,150,202,813,OOR
Reggie Williams,SF,26,73,1896,384,855,0.449,57,157,0.363,327,698,0.468,0.482,166,197,0.843,133,173,306,133,113,41,112,253,991,OOR
Scott Williams,PF,22,51,337,53,104,0.51,1,2,0.5,52,102,0.51,0.514,20,28,0.714,42,56,98,16,12,13,23,51,127,OOR
Kevin Willis,PF,28,80,2373,444,881,0.504,4,10,0.4,440,871,0.505,0.506,159,238,0.668,259,445,704,99,60,40,153,235,1051,OOR
Trevor Wilson,PF,22,25,162,21,70,0.3,0,2,0.0,21,68,0.309,0.3,13,26,0.5,16,24,40,11,5,1,17,13,55,OOR
Kennard Winchester,SF,24,64,607,98,245,0.4,8,20,0.4,90,225,0.4,0.416,35,45,0.778,34,33,67,25,16,13,30,70,239,OOR
David Wingate,SG,27,25,563,53,138,0.384,1,9,0.111,52,129,0.403,0.388,29,41,0.707,24,51,75,46,19,5,42,66,136,OOR
Randy Wittman,SF,31,41,355,35,79,0.443,0,5,0.0,35,74,0.473,0.443,4,6,0.667,6,27,33,25,10,4,10,9,74,OOR
Joe Wolf,C,26,74,1593,234,519,0.451,2,15,0.133,232,504,0.46,0.453,69,83,0.831,136,264,400,107,60,31,95,244,539,OOR
David Wood,SF,26,82,1421,148,349,0.424,28,90,0.311,120,259,0.463,0.464,108,133,0.812,107,139,246,94,58,16,89,236,432,OOR
Leon Wood,SG,28,12,222,25,63,0.397,12,38,0.316,13,25,0.52,0.492,19,21,0.905,5,14,19,49,5,0,12,10,81,OOR
Mike Woodson,SG,32,15,171,26,77,0.338,1,7,0.143,25,70,0.357,0.344,11,13,0.846,3,10,13,15,5,5,12,18,64,OOR
Orlando Woolridge,SF,31,53,1823,490,983,0.498,0,4,0.0,490,979,0.501,0.498,350,439,0.797,141,220,361,119,69,23,152,145,1330,OOR
Haywoode Workman,PG,25,73,2034,234,515,0.454,12,50,0.24,222,465,0.477,0.466,101,133,0.759,51,191,242,353,87,7,135,162,581,OOR
James Worthy,SF,29,78,3008,716,1455,0.492,26,90,0.289,690,1365,0.505,0.501,212,266,0.797,107,249,356,275,104,35,127,117,1670,OOR
Howard Wright,PF,23,15,164,19,47,0.404,0,1,0.0,19,46,0.413,0.404,16,24,0.667,12,33,45,3,4,5,11,28,54,OOR
A.J. Wynder,PG,26,6,39,3,12,0.25,0,1,0.0,3,11,0.273,0.25,6,8,0.75,1,2,3,8,1,0,4,1,12,OOR
Danny Young,PG,28,75,897,103,271,0.38,36,104,0.346,67,167,0.401,0.446,41,45,0.911,22,53,75,141,50,7,50,49,283,OOR
