Player,Pos,Age,G,MP,FG,FGA,FG%,3P,3PA,3P%,2P,2PA,2P%,eFG%,FT,FTA,FT%,ORB,DRB,TRB,AST,STL,BLK,TOV,PF,PTS,Status
Mahmoud Abdul-Rauf,PG,27,75,2131,411,924,0.445,94,246,0.382,317,678,0.468,0.496,115,136,0.846,16,106,122,189,56,6,119,174,1031,OOR
Shareef Abdur-Rahim,PF,20,80,2802,550,1214,0.453,7,27,0.259,543,1187,0.457,0.456,387,519,0.746,216,339,555,175,79,79,225,199,1494,OOR
Rafael Addison,SF,32,41,355,49,122,0.402,8,20,0.4,41,102,0.402,0.434,22,28,0.786,19,26,45,34,8,3,17,52,128,OOR
Cory Alexander,PG,23,80,1454,194,490,0.396,94,252,0.373,100,238,0.42,0.492,95,129,0.736,29,94,123,254,82,16,146,148,577,OOR
Jerome Allen,SG,24,76,943,78,221,0.353,30,93,0.323,48,128,0.375,0.421,42,72,0.583,25,73,98,152,31,4,69,84,228,OOR
Ray Allen,SG,21,82,2532,390,908,0.43,117,298,0.393,273,610,0.448,0.494,205,249,0.823,97,229,326,210,75,10,149,218,1102,OOR
Derrick Alston,C,24,2,11,0,5,0.0,0,0,0.0,0,5,0.0,0.0,0,2,0.0,3,1,4,0,0,0,0,0,0,OOR
Ashraf Amaya,PF,25,31,144,12,40,0.3,1,1,1.0,11,39,0.282,0.313,15,28,0.536,19,33,52,3,7,3,10,29,40,OOR
Greg Anderson,C,32,82,1659,130,262,0.496,0,1,0.0,130,261,0.498,0.496,62,93,0.667,157,291,448,34,63,67,73,225,322,OOR
Kenny Anderson,PG,26,82,3081,485,1137,0.427,132,366,0.361,353,771,0.458,0.485,334,435,0.768,91,272,363,584,162,15,193,222,1436,OOR
Nick Anderson,SG,29,63,2163,288,725,0.397,143,405,0.353,145,320,0.453,0.496,38,94,0.404,66,238,304,182,120,32,86,160,757,OOR
Shandon Anderson,SG,23,65,1066,147,318,0.462,24,47,0.511,123,271,0.454,0.5,68,99,0.687,52,127,179,49,27,8,73,113,386,OOR
Willie Anderson,SG,30,28,303,29,64,0.453,8,19,0.421,21,45,0.467,0.516,17,20,0.85,15,27,42,34,14,4,19,36,83,OOR
Greg Anthony,PG,29,65,1863,199,507,0.393,88,238,0.37,111,269,0.413,0.479,130,178,0.73,25,159,184,407,129,4,129,122,616,OOR
B.J. Armstrong,PG,29,49,1020,148,327,0.453,25,90,0.278,123,237,0.519,0.491,68,79,0.861,7,67,74,126,25,2,53,56,389,OOR
Darrell Armstrong,PG,28,67,1010,132,345,0.383,55,181,0.304,77,164,0.47,0.462,92,106,0.868,35,41,76,175,61,9,99,114,411,OOR
Vincent Askew,SG,30,43,838,81,186,0.435,7,24,0.292,74,162,0.457,0.454,70,88,0.795,25,73,98,90,17,6,46,123,239,OOR
Keith Askins,SF,29,78,1773,138,319,0.433,69,172,0.401,69,147,0.469,0.541,39,58,0.672,86,185,271,75,53,19,59,196,384,OOR
Stacey Augmon,SG,28,60,942,105,220,0.477,0,0,0.0,105,220,0.477,0.477,69,97,0.711,47,91,138,56,42,17,64,87,279,OOR
Isaac Austin,C,27,82,1881,321,639,0.502,0,3,0.0,321,636,0.505,0.502,150,226,0.664,136,342,478,101,45,43,161,244,792,OOR
Vin Baker,PF,25,78,3159,632,1251,0.505,15,54,0.278,617,1197,0.515,0.511,358,521,0.687,267,537,804,211,81,112,245,275,1637,OOR
Charles Barkley,PF,33,53,2009,335,692,0.484,58,205,0.283,277,487,0.569,0.526,288,415,0.694,212,504,716,248,69,25,151,153,1016,OOR
Dana Barros,PG,29,24,708,110,253,0.435,43,105,0.41,67,148,0.453,0.52,37,43,0.86,5,43,48,81,26,6,39,34,300,OOR
Brent Barry,SG,25,59,1094,155,379,0.409,56,173,0.324,99,206,0.481,0.483,76,93,0.817,30,80,110,154,51,15,76,88,442,OOR
Jon Barry,SG,27,58,965,100,246,0.407,48,124,0.387,52,122,0.426,0.504,37,46,0.804,26,73,99,115,55,3,59,56,285,OOR
Benoit Benjamin,C,32,4,44,5,12,0.417,0,0,0.0,5,12,0.417,0.417,3,4,0.75,3,6,9,1,1,0,2,5,13,OOR
Elmer Bennett,PG,26,9,75,6,19,0.316,3,9,0.333,3,10,0.3,0.395,7,10,0.7,0,4,4,11,4,0,10,7,22,OOR
Travis Best,PG,24,76,2064,274,620,0.442,57,155,0.368,217,465,0.467,0.488,149,197,0.756,36,130,166,318,98,5,153,221,754,OOR
Mookie Blaylock,PG,29,78,3056,501,1159,0.432,221,604,0.366,280,555,0.505,0.528,131,174,0.753,114,299,413,463,212,20,185,141,1354,OOR
Corie Blount,PF,28,58,1009,92,179,0.514,1,3,0.333,91,176,0.517,0.517,56,83,0.675,113,163,276,35,22,26,50,121,241,OOR
Muggsy Bogues,PG,32,65,1880,204,443,0.46,60,144,0.417,144,299,0.482,0.528,54,64,0.844,25,116,141,469,82,2,108,114,522,OOR
Dexter Boney,SG,26,8,48,6,19,0.316,1,6,0.167,5,13,0.385,0.342,6,8,0.75,3,3,6,0,2,1,1,3,19,OOR
Melvin Booker,PG,24,21,430,46,105,0.438,12,37,0.324,34,68,0.5,0.495,18,20,0.9,7,22,29,53,3,2,27,28,122,OOR
Bruce Bowen,SF,25,1,1,0,0,0.0,0,0,0.0,0,0,0.0,0.0,0,0,0.0,0,0,0,0,0,1,0,0,0,OOR
Donnie Boyce,SG,23,22,154,21,63,0.333,2,16,0.125,19,47,0.404,0.349,11,22,0.5,7,8,15,13,10,4,16,17,55,OOR
Shawn Bradley,C,24,73,2288,406,905,0.449,0,8,0.0,406,897,0.453,0.449,149,228,0.654,221,390,611,52,40,248,134,237,961,OOR
Mark Bradtke,C,28,36,251,25,58,0.431,0,0,0.0,25,58,0.431,0.431,9,13,0.692,26,42,68,7,5,5,9,34,59,OOR
Terrell Brandon,PG,26,78,2868,575,1313,0.438,101,271,0.373,474,1042,0.455,0.476,268,297,0.902,48,253,301,490,138,30,178,177,1519,OOR
Frank Brickowski,PF,37,17,255,32,73,0.438,7,20,0.35,25,53,0.472,0.486,10,14,0.714,6,28,34,15,5,4,19,42,81,OOR
Scott Brooks,PG,31,38,251,19,39,0.487,5,12,0.417,14,27,0.519,0.551,14,15,0.933,6,12,18,29,21,0,17,35,57,OOR
Chucky Brown,SF,28,70,757,78,154,0.506,1,6,0.167,77,148,0.52,0.51,47,70,0.671,41,107,148,28,9,22,19,100,204,OOR
Dee Brown,PG,28,21,522,61,166,0.367,20,65,0.308,41,101,0.406,0.428,18,22,0.818,8,40,48,67,31,7,24,45,160,OOR
Marcus Brown,PG,22,21,184,28,70,0.4,13,32,0.406,15,38,0.395,0.493,13,19,0.684,4,11,15,20,8,2,13,26,82,OOR
Mike Brown,C,33,6,83,5,12,0.417,0,0,0.0,5,12,0.417,0.417,6,10,0.6,9,16,25,5,1,1,2,9,16,OOR
P.J. Brown,PF,27,80,2592,300,656,0.457,0,2,0.0,300,654,0.459,0.457,161,220,0.732,239,431,670,92,85,98,113,283,761,OOR
Randy Brown,PG,28,72,1057,140,333,0.42,4,22,0.182,136,311,0.437,0.426,57,84,0.679,34,77,111,133,81,17,58,116,341,OOR
Kobe Bryant,SF,18,71,1103,176,422,0.417,51,136,0.375,125,286,0.437,0.477,136,166,0.819,47,85,132,91,49,23,112,102,539,OOR
Mark Bryant,PF,31,41,1018,152,275,0.553,0,0,0.0,152,275,0.553,0.553,76,108,0.704,67,145,212,47,22,5,46,136,380,OOR
Jud Buechler,SF,28,76,703,58,158,0.367,18,54,0.333,40,104,0.385,0.424,5,14,0.357,45,81,126,60,23,21,27,50,139,OOR
Matt Bullard,PF,29,71,1025,114,284,0.401,67,183,0.366,47,101,0.465,0.519,25,34,0.735,13,104,117,67,21,18,38,68,320,OOR
Scott Burrell,SF,26,57,939,98,271,0.362,41,116,0.353,57,155,0.368,0.437,57,76,0.75,49,109,158,74,28,19,53,120,294,OOR
Willie Burton,SF,28,24,380,39,116,0.336,13,46,0.283,26,70,0.371,0.392,57,68,0.838,11,30,41,11,8,3,26,55,148,OOR
Mitchell Butler,SG,26,49,465,52,125,0.416,12,39,0.308,40,86,0.465,0.464,32,50,0.64,19,34,53,30,13,2,27,55,148,OOR
Jason Caffey,PF,23,75,1405,205,385,0.532,0,1,0.0,205,384,0.534,0.532,139,211,0.659,135,166,301,89,25,9,97,149,549,OOR
Michael Cage,C,35,82,1247,66,141,0.468,0,0,0.0,66,141,0.468,0.468,19,41,0.463,112,208,320,43,48,42,17,118,151,OOR
Adrian Caldwell,PF,30,45,569,40,92,0.435,0,2,0.0,40,90,0.444,0.435,21,50,0.42,58,109,167,12,16,8,28,87,101,OOR
Marcus Camby,C,22,63,1897,375,778,0.482,2,14,0.143,373,764,0.488,0.483,183,264,0.693,131,263,394,97,66,130,134,214,935,OOR
Elden Campbell,PF,28,77,2516,442,942,0.469,1,4,0.25,441,938,0.47,0.47,263,370,0.711,207,408,615,126,46,117,130,276,1148,OOR
Antoine Carr,PF,35,82,1460,252,522,0.483,0,3,0.0,252,519,0.486,0.483,99,127,0.78,60,135,195,74,24,63,75,214,603,OOR
Chris Carr,SG,22,55,830,125,271,0.461,31,88,0.352,94,183,0.514,0.518,56,73,0.767,31,82,113,48,24,10,37,93,337,OOR
Jimmy Carruth,PF,27,4,21,2,3,0.667,0,0,0.0,2,3,0.667,0.667,1,1,1.0,0,4,4,0,0,2,1,4,5,OOR
Sam Cassell,PG,27,61,1714,337,783,0.43,81,231,0.351,256,552,0.464,0.482,212,251,0.845,47,135,182,305,77,19,168,200,967,OOR
Duane Causwell,C,28,46,581,48,94,0.511,2,3,0.667,46,91,0.505,0.521,20,37,0.541,57,70,127,20,15,38,34,131,118,OOR
Cedric Ceballos,SF,27,50,1426,282,617,0.457,26,102,0.255,256,515,0.497,0.478,139,186,0.747,102,228,330,64,33,23,85,113,729,OOR
Tom Chambers,PF,37,12,83,7,31,0.226,2,3,0.667,5,28,0.179,0.258,3,4,0.75,3,11,14,4,1,0,9,14,19,OOR
Rex Chapman,SG,29,65,1833,332,749,0.443,110,314,0.35,222,435,0.51,0.517,124,149,0.832,25,156,181,182,52,7,96,108,898,OOR
Calbert Cheaney,SG,25,79,2411,369,730,0.505,4,30,0.133,365,700,0.521,0.508,95,137,0.693,70,198,268,114,77,18,94,226,837,OOR
Pete Chilcutt,PF,28,54,662,72,165,0.436,25,69,0.362,47,96,0.49,0.512,13,22,0.591,67,89,156,47,26,17,28,52,182,OOR
Randolph Childress,PG,24,23,155,14,40,0.35,5,19,0.263,9,21,0.429,0.413,6,8,0.75,1,5,6,17,9,0,18,16,39,OOR
Chris Childs,PG,29,65,2076,211,510,0.414,70,181,0.387,141,329,0.429,0.482,113,149,0.758,22,169,191,398,78,11,180,213,605,OOR
Doug Christie,SG,26,81,3127,396,949,0.417,147,383,0.384,249,566,0.44,0.495,237,306,0.775,85,347,432,315,201,45,200,245,1176,OOR
Derrick Coleman,PF,29,57,2102,364,836,0.435,32,119,0.269,332,717,0.463,0.455,272,365,0.745,157,416,573,193,50,75,184,164,1032,OOR
Bimbo Coles,PG,28,51,1183,122,314,0.389,30,102,0.294,92,212,0.434,0.436,37,49,0.755,39,79,118,149,35,7,59,96,311,OOR
Marty Conlon,C,29,74,1614,214,454,0.471,2,10,0.2,212,444,0.477,0.474,144,171,0.842,128,195,323,104,46,18,109,154,574,OOR
Tyrone Corbin,SF,34,70,2305,253,600,0.422,74,208,0.356,179,392,0.457,0.483,86,108,0.796,76,218,294,124,90,7,85,176,666,OOR
Joe Courtney,PF,27,9,100,11,30,0.367,0,0,0.0,11,30,0.367,0.367,3,5,0.6,9,7,16,0,0,0,3,14,25,OOR
John Crotty,PG,27,48,659,79,154,0.513,20,49,0.408,59,105,0.562,0.578,54,64,0.844,15,32,47,102,18,0,42,79,232,OOR
Terry Cummings,PF,35,45,828,155,319,0.486,3,5,0.6,152,314,0.484,0.491,57,82,0.695,70,113,183,39,33,7,45,113,370,OOR
Earl Cureton,PF,39,9,46,3,8,0.375,0,0,0.0,3,8,0.375,0.375,1,3,0.333,4,5,9,4,0,0,1,10,7,OOR
Dell Curry,SG,32,68,2078,384,836,0.459,126,296,0.426,258,540,0.478,0.535,114,142,0.803,40,171,211,118,60,14,93,147,1008,OOR
Michael Curry,SG,28,81,1217,99,221,0.448,23,77,0.299,76,144,0.528,0.5,97,108,0.898,23,96,119,43,31,12,28,128,318,OOR
Erick Dampier,C,21,72,1052,131,336,0.39,1,1,1.0,130,335,0.388,0.391,107,168,0.637,96,198,294,43,19,73,84,153,370,OOR
Lloyd Daniels,SG,29,22,310,36,119,0.303,21,70,0.3,15,49,0.306,0.391,5,6,0.833,19,24,43,26,10,3,14,33,98,OOR
Sasha Danilović,SG,26,56,1789,248,570,0.435,85,236,0.36,163,334,0.488,0.51,121,151,0.801,29,107,136,102,54,9,116,160,702,OOR
Yinka Dare,C,24,41,313,19,54,0.352,0,0,0.0,19,54,0.352,0.352,19,37,0.514,35,47,82,3,4,28,21,51,57,OOR
Antonio Davis,PF,28,82,2335,308,641,0.48,1,14,0.071,307,627,0.49,0.481,241,362,0.666,190,408,598,65,42,84,141,260,858,OOR
Ben Davis,PF,24,20,98,10,26,0.385,0,0,0.0,10,26,0.385,0.385,9,20,0.45,12,15,27,0,4,1,3,16,29,OOR
Dale Davis,PF,27,80,2589,370,688,0.538,0,0,0.0,370,688,0.538,0.538,92,215,0.428,301,471,772,59,60,77,108,233,832,OOR
Emanual Davis,PG,28,13,230,24,54,0.444,12,27,0.444,12,27,0.444,0.556,5,8,0.625,2,20,22,26,9,2,17,20,65,OOR
Hubert Davis,SG,26,36,623,74,184,0.402,16,70,0.229,58,114,0.509,0.446,17,23,0.739,11,29,40,34,11,2,21,40,181,OOR
Mark Davis,SF,23,75,1705,251,535,0.469,24,93,0.258,227,442,0.514,0.492,113,168,0.673,138,185,323,135,85,31,118,230,639,OOR
Todd Day,SG,27,81,2277,398,999,0.398,126,348,0.362,272,651,0.418,0.461,256,331,0.773,109,221,330,117,108,48,127,208,1178,OOR
Andrew DeClercq,C,23,71,1065,142,273,0.52,0,0,0.0,142,273,0.52,0.52,91,151,0.603,122,176,298,32,33,27,76,229,375,OOR
Terry Dehere,PG,25,73,1053,148,383,0.386,52,160,0.325,96,223,0.43,0.454,122,148,0.824,15,80,95,158,27,3,96,142,470,OOR
Vinny Del Negro,SG,30,72,2243,365,781,0.467,44,140,0.314,321,641,0.501,0.496,112,129,0.868,39,171,210,231,59,7,92,131,886,OOR
Bison Dele,C,27,9,138,26,63,0.413,0,0,0.0,26,63,0.413,0.413,11,15,0.733,14,19,33,12,3,5,11,20,63,OOR
Tony Delk,PG,23,61,867,119,256,0.465,52,112,0.464,67,144,0.465,0.566,42,51,0.824,31,68,99,99,36,6,68,71,332,OOR
Dell Demps,SG,26,2,10,0,3,0.0,0,1,0.0,0,2,0.0,0.0,2,2,1.0,0,0,0,0,1,0,0,1,2,OOR
Vlade Divac,C,28,81,2840,418,847,0.494,11,47,0.234,407,800,0.509,0.5,177,259,0.683,241,484,725,301,103,180,193,277,1024,OOR
Sherman Douglas,PG,30,79,2316,306,610,0.502,38,114,0.333,268,496,0.54,0.533,114,171,0.667,57,136,193,427,78,10,153,191,764,OOR
Greg Dreiling,C,34,40,389,34,74,0.459,1,1,1.0,33,73,0.452,0.466,11,27,0.407,19,57,76,11,8,7,9,65,80,OOR
Clyde Drexler,SG,34,62,2271,397,899,0.442,119,335,0.355,278,564,0.493,0.508,201,268,0.75,118,255,373,354,119,36,156,151,1114,OOR
Nate Driggers,SG,23,15,132,13,43,0.302,0,9,0.0,13,34,0.382,0.302,10,14,0.714,12,10,22,6,3,2,6,10,36,OOR
Kevin Duckworth,C,32,26,384,45,103,0.437,3,4,0.75,42,99,0.424,0.451,11,16,0.688,23,37,60,16,9,11,33,63,104,OOR
Chris Dudley,C,31,81,1840,126,293,0.43,0,0,0.0,126,293,0.43,0.43,65,137,0.474,204,389,593,41,39,96,80,247,317,OOR
Joe Dumars,SG,33,79,2923,385,875,0.44,166,384,0.432,219,491,0.446,0.535,222,256,0.867,38,153,191,318,57,1,128,97,1158,OOR
Tony Dumas,SG,24,24,278,33,96,0.344,4,28,0.143,29,68,0.426,0.365,16,25,0.64,3,13,16,25,10,2,16,45,86,OOR
Acie Earl,C,26,47,500,67,180,0.372,0,5,0.0,67,175,0.383,0.372,54,84,0.643,35,61,96,20,15,28,35,61,188,OOR
Tyus Edney,PG,23,70,1376,150,391,0.384,8,42,0.19,142,349,0.407,0.394,177,215,0.823,34,79,113,226,60,2,112,98,485,OOR
Blue Edwards,SF,31,61,1439,182,458,0.397,25,89,0.281,157,369,0.425,0.425,89,109,0.817,49,140,189,114,38,20,81,135,478,OOR
Kevin Edwards,PG,31,32,477,69,183,0.377,15,43,0.349,54,140,0.386,0.418,37,43,0.86,9,34,43,57,17,4,49,34,190,OOR
Craig Ehlo,SG,35,62,848,87,248,0.351,27,95,0.284,60,153,0.392,0.405,13,26,0.5,39,71,110,68,36,4,45,71,214,OOR
Howard Eisley,PG,24,82,1083,139,308,0.451,20,72,0.278,119,236,0.504,0.484,70,89,0.787,20,64,84,198,44,10,110,141,368,OOR
Mario Elie,SF,33,78,2687,291,585,0.497,120,286,0.42,171,299,0.572,0.6,207,231,0.896,60,175,235,310,92,12,135,200,909,OOR
Sean Elliott,SF,28,39,1393,196,464,0.422,42,126,0.333,154,338,0.456,0.468,148,196,0.755,48,142,190,124,24,24,89,105,582,OOR
Dale Ellis,SF,36,82,2940,477,1151,0.414,192,528,0.364,285,623,0.457,0.498,215,263,0.817,99,194,293,165,60,7,146,178,1361,OOR
LaPhonso Ellis,PF,26,55,2002,445,1014,0.439,95,259,0.367,350,755,0.464,0.486,218,282,0.773,107,279,386,131,44,41,117,181,1203,OOR
Pervis Ellison,PF,29,6,125,6,16,0.375,0,0,0.0,6,16,0.375,0.375,3,5,0.6,9,17,26,4,5,9,7,21,15,OOR
Brian Evans,SF,23,14,59,8,22,0.364,4,8,0.5,4,14,0.286,0.455,0,0,0.0,1,7,8,7,1,2,2,6,20,OOR
Patrick Ewing,C,34,78,2887,655,1342,0.488,2,9,0.222,653,1333,0.49,0.489,439,582,0.754,175,659,834,156,69,189,269,250,1751,OOR
Jamie Feick,PF-C,22,41,624,56,157,0.357,5,14,0.357,51,143,0.357,0.373,34,67,0.507,82,132,214,26,16,14,31,78,151,OOR
Duane Ferrell,SF,31,62,1115,159,337,0.472,18,44,0.409,141,293,0.481,0.499,58,94,0.617,57,84,141,66,38,6,55,120,394,OOR
Danny Ferry,PF,30,82,2633,341,794,0.429,114,284,0.401,227,510,0.445,0.501,74,87,0.851,82,255,337,151,56,32,94,245,870,OOR
Michael Finley,SF,23,83,2790,475,1071,0.444,101,280,0.361,374,791,0.473,0.491,198,245,0.808,88,284,372,224,68,24,164,138,1249,OOR
Matt Fish,C,27,6,8,1,3,0.333,0,0,0.0,1,3,0.333,0.333,0,0,0.0,1,4,5,0,0,0,2,2,2,OOR
Derek Fisher,PG,22,80,921,104,262,0.397,22,73,0.301,82,189,0.434,0.439,79,120,0.658,25,72,97,119,41,5,71,87,309,OOR
Greg Foster,C,28,79,920,111,245,0.453,2,3,0.667,109,242,0.45,0.457,54,65,0.831,56,131,187,31,10,20,54,145,278,OOR
Rick Fox,SF,27,76,2650,433,950,0.456,101,278,0.363,332,672,0.494,0.509,207,263,0.787,114,280,394,286,167,40,178,279,1174,OOR
Todd Fuller,C,22,75,949,114,266,0.429,0,0,0.0,114,266,0.429,0.429,76,110,0.691,108,141,249,24,10,20,52,146,304,OOR
Kevin Gamble,SF,31,62,953,123,286,0.43,54,112,0.482,69,174,0.397,0.524,7,10,0.7,13,94,107,77,21,17,27,76,307,OOR
Kevin Garnett,SF,20,77,2995,549,1100,0.499,6,21,0.286,543,1079,0.503,0.502,205,272,0.754,190,428,618,236,105,163,175,199,1309,OOR
Dean Garrett,C,30,68,1665,223,389,0.573,0,0,0.0,223,389,0.573,0.573,96,138,0.696,149,346,495,38,40,95,34,158,542,OOR
Chris Gatling,PF,29,47,1283,327,623,0.525,1,6,0.167,326,617,0.528,0.526,236,329,0.717,134,236,370,28,39,31,120,138,891,OOR
Reggie Geary,PG,23,39,246,22,58,0.379,8,21,0.381,14,37,0.378,0.448,5,11,0.455,4,11,15,36,13,2,15,36,57,OOR
Matt Geiger,C,27,49,1044,171,350,0.489,6,20,0.3,165,330,0.5,0.497,89,127,0.701,100,158,258,38,20,27,67,153,437,OOR
Kendall Gill,SF,28,82,3199,644,1453,0.443,74,220,0.336,570,1233,0.462,0.469,427,536,0.797,183,316,499,326,154,46,218,225,1789,OOR
Armen Gilliam,PF,32,80,2050,246,522,0.471,0,0,0.0,246,522,0.471,0.471,199,259,0.768,136,361,497,53,61,40,105,206,691,OOR
Anthony Goldwire,PG,25,60,1188,131,330,0.397,64,153,0.418,67,177,0.379,0.494,61,78,0.782,12,72,84,219,33,2,76,104,387,OOR
Greg Graham,SG,26,28,197,29,80,0.363,9,31,0.29,20,49,0.408,0.419,26,40,0.65,2,11,13,11,12,1,10,12,93,OOR
Brian Grant,PF,24,24,607,91,207,0.44,0,0,0.0,91,207,0.44,0.44,70,90,0.778,49,93,142,28,19,25,44,75,252,OOR
Gary Grant,PG,31,28,365,39,110,0.355,14,46,0.304,25,64,0.391,0.418,18,22,0.818,8,30,38,45,16,0,27,39,110,OOR
Harvey Grant,PF,31,78,1604,129,314,0.411,28,89,0.315,101,225,0.449,0.455,30,39,0.769,63,193,256,68,46,48,30,167,316,OOR
Horace Grant,PF,31,67,2496,358,695,0.515,1,6,0.167,357,689,0.518,0.516,128,179,0.715,206,394,600,163,101,65,99,157,845,OOR
Devin Gray,PF,24,6,49,8,26,0.308,0,0,0.0,8,26,0.308,0.308,2,5,0.4,6,8,14,2,4,0,5,11,18,OOR
Evric Gray,SF,27,5,42,4,15,0.267,1,4,0.25,3,11,0.273,0.3,4,4,1.0,1,2,3,2,1,0,3,5,13,OOR
Jeff Grayer,SG,31,25,316,38,83,0.458,4,11,0.364,34,72,0.472,0.482,11,20,0.55,21,17,38,25,8,7,15,42,91,OOR
A.C. Green,PF,33,83,2492,234,484,0.483,1,20,0.05,233,464,0.502,0.485,128,197,0.65,222,434,656,69,70,16,74,145,597,OOR
Litterial Green,PG,26,45,311,30,64,0.469,0,10,0.0,30,54,0.556,0.469,30,47,0.638,6,16,22,41,16,1,15,27,90,OOR
Tom Gugliotta,PF,27,81,3131,592,1339,0.442,24,93,0.258,568,1246,0.456,0.451,464,566,0.82,187,515,702,335,130,89,293,237,1672,OOR
Jack Haley,C,33,20,74,13,37,0.351,0,0,0.0,13,37,0.351,0.351,14,19,0.737,13,19,32,5,1,1,2,14,40,OOR
Darvin Ham,SF,23,36,318,33,62,0.532,0,0,0.0,33,62,0.532,0.532,17,35,0.486,29,27,56,14,9,8,22,57,83,OOR
Steve Hamer,C,23,35,268,30,57,0.526,0,2,0.0,30,55,0.545,0.526,16,29,0.552,17,43,60,7,2,4,13,39,76,OOR
Tom Hammonds,PF,29,81,1758,191,398,0.48,0,2,0.0,191,396,0.482,0.48,124,172,0.721,135,266,401,64,16,24,88,205,506,OOR
Darrin Hancock,SF,25,24,133,16,35,0.457,0,0,0.0,16,35,0.457,0.457,10,14,0.714,4,14,18,12,9,1,11,15,42,OOR
Anfernee Hardaway,PG,25,59,2221,421,941,0.447,85,267,0.318,336,674,0.499,0.493,283,345,0.82,82,181,263,332,93,35,145,123,1210,OOR
Tim Hardaway,PG,30,81,3136,575,1384,0.415,203,590,0.344,372,794,0.469,0.489,291,364,0.799,49,228,277,695,151,9,230,165,1644,Candidate
Derek Harper,PG,35,75,2210,299,674,0.444,60,176,0.341,239,498,0.48,0.488,95,128,0.742,30,107,137,321,92,12,132,144,753,OOR
Ron Harper,PG,33,76,1740,177,406,0.436,68,188,0.362,109,218,0.5,0.52,58,82,0.707,46,147,193,191,86,38,50,138,480,OOR
Othella Harrington,PF,23,57,860,112,204,0.549,0,3,0.0,112,201,0.557,0.549,49,81,0.605,75,123,198,18,12,22,57,112,273,OOR
Lucious Harris,SG,26,54,813,112,294,0.381,36,99,0.364,76,195,0.39,0.442,33,47,0.702,27,44,71,50,41,3,34,45,293,OOR
Antonio Harvey,PF,26,6,26,5,11,0.455,0,0,0.0,5,11,0.455,0.455,5,6,0.833,2,8,10,1,0,4,1,8,15,OOR
Hersey Hawkins,SG,30,82,2755,369,795,0.464,143,355,0.403,226,440,0.514,0.554,258,295,0.875,92,228,320,250,159,12,130,146,1139,OOR
Michael Hawkins,PG,24,29,326,29,68,0.426,10,31,0.323,19,37,0.514,0.5,12,15,0.8,9,22,31,64,16,1,28,40,80,OOR
Shane Heal,PG,26,43,236,26,97,0.268,20,65,0.308,6,32,0.188,0.371,3,5,0.6,2,16,18,33,3,3,17,20,75,OOR
Alan Henderson,PF,24,30,501,77,162,0.475,0,0,0.0,77,162,0.475,0.475,45,75,0.6,47,69,116,23,21,6,29,73,199,OOR
Mark Hendrickson,PF,22,29,301,32,77,0.416,3,12,0.25,29,65,0.446,0.435,18,26,0.692,35,57,92,3,10,4,14,32,85,OOR
Carl Herrera,PF,30,75,1837,257,593,0.433,2,6,0.333,255,587,0.434,0.435,81,118,0.686,118,222,340,50,62,53,95,217,597,OOR
Grant Hill,SF,24,80,3147,625,1259,0.496,10,33,0.303,615,1226,0.502,0.5,450,633,0.711,123,598,721,583,144,48,259,186,1710,Candidate
Tyrone Hill,C,28,74,2582,357,595,0.6,0,1,0.0,357,594,0.601,0.6,241,381,0.633,259,477,736,92,63,30,147,268,955,OOR
Fred Hoiberg,SG,24,47,572,67,156,0.429,29,70,0.414,38,86,0.442,0.522,61,77,0.792,13,68,81,41,27,6,22,51,224,OOR
Jeff Hornacek,SG,33,82,2592,413,856,0.482,72,195,0.369,341,661,0.516,0.525,293,326,0.899,60,181,241,361,124,26,134,188,1191,OOR
Robert Horry,SF,26,54,1395,157,360,0.436,49,154,0.318,108,206,0.524,0.504,60,90,0.667,68,169,237,110,66,55,72,153,423,OOR
Allan Houston,SG,25,81,2681,437,1032,0.423,148,384,0.385,289,648,0.446,0.495,175,218,0.803,43,197,240,179,41,18,167,233,1197,OOR
Juwan Howard,SF,23,82,3324,638,1313,0.486,0,2,0.0,638,1311,0.487,0.486,294,389,0.756,202,450,652,311,93,23,246,259,1570,OOR
Stephen Howard,SF,26,49,418,62,108,0.574,0,0,0.0,62,108,0.574,0.574,52,81,0.642,29,56,85,11,19,12,25,62,176,OOR
Lindsey Hunter,PG,26,82,3023,421,1042,0.404,166,468,0.355,255,574,0.444,0.484,158,203,0.778,59,174,233,154,129,24,96,206,1166,OOR
Bobby Hurley,PG,25,49,632,46,125,0.368,14,45,0.311,32,80,0.4,0.424,37,53,0.698,9,29,38,146,27,3,55,53,143,OOR
Allen Iverson,PG,21,76,3045,625,1504,0.416,155,455,0.341,470,1049,0.448,0.467,382,544,0.702,115,197,312,567,157,24,337,233,1787,OOR
Jaren Jackson,SG,29,75,1133,134,329,0.407,53,158,0.335,81,171,0.474,0.488,53,69,0.768,31,101,132,65,45,16,60,131,374,OOR
Jim Jackson,SG-SF,26,77,2831,444,1029,0.431,86,247,0.348,358,782,0.458,0.473,252,310,0.813,132,279,411,316,86,32,208,194,1226,OOR
Mark Jackson,PG,31,82,3054,289,679,0.426,66,178,0.371,223,501,0.445,0.474,168,213,0.789,91,304,395,935,97,12,274,161,812,OOR
Henry James,PF,31,53,945,125,306,0.408,76,181,0.42,49,125,0.392,0.533,30,36,0.833,27,54,81,21,11,1,29,98,356,OOR
Chris Jent,SF,27,3,10,2,6,0.333,2,3,0.667,0,3,0.0,0.5,0,0,0.0,1,0,1,1,0,0,0,2,6,OOR
Avery Johnson,PG,31,76,2472,327,685,0.477,6,26,0.231,321,659,0.487,0.482,140,203,0.69,32,115,147,513,96,15,146,158,800,OOR
Eddie Johnson,SF,37,52,913,160,362,0.442,49,131,0.374,111,231,0.481,0.51,55,68,0.809,27,111,138,52,15,2,47,81,424,OOR
Ervin Johnson,C,29,82,2599,243,467,0.52,0,2,0.0,243,465,0.523,0.52,96,156,0.615,231,682,913,71,65,227,118,288,582,OOR
Kevin Johnson,PG,30,70,2658,441,890,0.496,89,202,0.441,352,688,0.512,0.546,439,515,0.852,54,199,253,653,102,12,217,141,1410,OOR
Larry Johnson,SF,27,76,2613,376,735,0.512,34,105,0.324,342,630,0.543,0.535,190,274,0.693,165,228,393,174,64,36,136,249,976,OOR
Charles Jones,PF,39,12,93,2,5,0.4,0,0,0.0,2,5,0.4,0.4,0,0,0.0,5,8,13,3,2,4,0,8,4,OOR
Eddie Jones,SG,25,80,2998,473,1081,0.438,152,389,0.391,321,692,0.464,0.508,276,337,0.819,90,236,326,270,189,49,169,226,1374,OOR
Popeye Jones,PF,26,79,2421,258,537,0.48,1,13,0.077,257,524,0.49,0.481,99,121,0.818,270,410,680,84,58,39,116,269,616,OOR
Michael Jordan,SG,33,82,3106,920,1892,0.486,111,297,0.374,809,1595,0.507,0.516,480,576,0.833,113,369,482,352,140,44,166,156,2431,Candidate
Reggie Jordan,SG,29,19,130,16,26,0.615,0,0,0.0,16,26,0.615,0.615,8,17,0.471,11,16,27,12,7,3,8,15,40,OOR
Adam Keefe,C,26,62,915,82,160,0.513,0,1,0.0,82,159,0.516,0.513,71,103,0.689,75,141,216,32,30,13,45,97,235,OOR
Shawn Kemp,PF,27,81,2750,526,1032,0.51,12,33,0.364,514,999,0.515,0.516,452,609,0.742,275,532,807,156,125,81,280,320,1516,OOR
Tim Kempton,PF,33,10,59,1,5,0.2,0,0,0.0,1,5,0.2,0.2,2,2,1.0,3,5,8,2,1,1,7,4,4,OOR
Steve Kerr,PG,31,82,1861,249,467,0.533,110,237,0.464,139,230,0.604,0.651,54,67,0.806,29,101,130,175,67,3,43,98,662,OOR
Jerome Kersey,SF,34,70,1766,194,449,0.432,17,65,0.262,177,384,0.461,0.451,71,118,0.602,112,251,363,89,119,49,74,219,476,OOR
Jason Kidd,PG,23,55,1964,213,529,0.403,61,165,0.37,152,364,0.418,0.46,112,165,0.679,64,185,249,496,124,20,142,114,599,OOR
Frankie King,SG,24,7,59,7,17,0.412,1,2,0.5,6,15,0.4,0.441,5,5,1.0,4,10,14,5,4,0,3,7,20,OOR
Jimmy King,SG,23,2,22,2,6,0.333,0,0,0.0,2,6,0.333,0.333,2,4,0.5,2,0,2,2,3,0,1,2,6,OOR
Stacey King,C,30,11,103,11,22,0.5,0,0,0.0,11,22,0.5,0.5,2,7,0.286,11,16,27,1,2,1,6,14,24,OOR
Kerry Kittles,SG,22,82,3012,507,1189,0.426,158,419,0.377,349,770,0.453,0.493,175,227,0.771,106,213,319,249,157,35,127,165,1347,OOR
Joe Kleine,C,35,59,848,69,170,0.406,2,3,0.667,67,167,0.401,0.412,28,38,0.737,62,141,203,35,17,18,41,110,168,OOR
Travis Knight,C,22,71,1156,140,275,0.509,0,0,0.0,140,275,0.509,0.509,62,100,0.62,130,189,319,39,31,58,49,170,342,OOR
Larry Krystkowiak,PF,32,3,11,1,2,0.5,0,0,0.0,1,2,0.5,0.5,1,2,0.5,2,3,5,3,2,0,1,3,3,OOR
Toni Kukoč,SF,28,57,1610,285,605,0.471,50,151,0.331,235,454,0.518,0.512,134,174,0.77,94,167,261,256,60,29,91,97,754,OOR
Christian Laettner,PF,27,82,3140,548,1128,0.486,31,88,0.352,517,1040,0.497,0.5,359,440,0.816,212,508,720,223,102,64,218,277,1486,OOR
Andrew Lang,C,30,52,1194,115,248,0.464,0,0,0.0,115,248,0.464,0.464,44,61,0.721,94,184,278,25,26,47,39,140,274,OOR
Antonio Lang,PF,24,64,843,68,162,0.42,0,6,0.0,68,156,0.436,0.42,35,48,0.729,52,75,127,33,33,30,50,111,171,OOR
Priest Lauderdale,C,23,35,180,49,89,0.551,0,1,0.0,49,88,0.557,0.551,13,23,0.565,16,27,43,12,1,9,37,39,111,OOR
Eric Leckner,C,30,20,126,14,33,0.424,0,0,0.0,14,33,0.424,0.424,6,12,0.5,5,31,36,5,3,2,10,35,34,OOR
Tim Legler,SG,30,15,182,15,48,0.313,8,29,0.276,7,19,0.368,0.396,6,7,0.857,0,21,21,7,3,5,9,21,44,OOR
Voshon Lenard,SG,23,73,2111,314,684,0.459,183,442,0.414,131,242,0.541,0.593,86,105,0.819,38,179,217,161,50,18,109,168,897,OOR
Martin Lewis,SF,21,9,50,6,14,0.429,1,3,0.333,5,11,0.455,0.464,1,2,0.5,4,2,6,4,1,2,1,8,14,OOR
Alton Lister,C,38,53,516,32,77,0.416,0,0,0.0,32,77,0.416,0.416,23,31,0.742,66,102,168,13,8,14,30,95,87,OOR
Randy Livingston,PG,21,64,981,100,229,0.437,9,22,0.409,91,207,0.44,0.456,42,65,0.646,32,62,94,155,39,12,102,107,251,OOR
Horacio Llamas,C,23,20,101,15,28,0.536,0,0,0.0,15,28,0.536,0.536,4,8,0.5,4,14,18,4,10,5,11,25,34,OOR
Brad Lohaus,PF,32,6,45,4,15,0.267,2,7,0.286,2,8,0.25,0.333,0,0,0.0,1,6,7,1,1,0,1,6,10,OOR
Grant Long,PF,30,65,1166,123,275,0.447,17,47,0.362,106,228,0.465,0.478,63,84,0.75,88,134,222,39,43,6,48,106,326,OOR
John Long,SG,40,32,370,46,117,0.393,12,34,0.353,34,83,0.41,0.444,25,28,0.893,6,34,40,21,9,2,24,28,129,OOR
Luc Longley,C,28,59,1472,221,485,0.456,0,2,0.0,221,483,0.458,0.456,95,120,0.792,121,211,332,141,23,66,111,191,537,OOR
George Lynch,SF,26,41,1059,137,291,0.471,8,31,0.258,129,260,0.496,0.485,60,97,0.619,98,163,261,76,63,17,64,97,342,OOR
Sam Mack,SF,26,52,904,105,262,0.401,47,142,0.331,58,120,0.483,0.49,35,42,0.833,20,86,106,58,29,6,42,67,292,OOR
Don MacLean,SF,27,37,733,163,365,0.447,12,38,0.316,151,327,0.462,0.463,64,97,0.66,41,99,140,37,12,10,47,71,402,OOR
Rick Mahorn,C,38,22,218,20,54,0.37,0,1,0.0,20,53,0.377,0.37,16,22,0.727,19,34,53,6,4,3,10,34,56,OOR
Dan Majerle,SF,31,36,1264,141,347,0.406,68,201,0.338,73,146,0.5,0.504,40,59,0.678,45,117,162,116,54,14,50,75,390,OOR
Karl Malone,PF,33,82,2998,864,1571,0.55,0,13,0.0,864,1558,0.555,0.55,521,690,0.755,193,616,809,368,113,48,233,217,2249,MVP
Matt Maloney,PG,25,82,2386,271,615,0.441,154,381,0.404,117,234,0.5,0.566,71,93,0.763,19,141,160,303,82,1,122,125,767,OOR
Danny Manning,PF,30,77,2134,426,795,0.536,7,36,0.194,419,759,0.552,0.54,181,251,0.721,137,332,469,173,81,74,161,268,1040,OOR
Rich Manning,PF,26,26,201,32,82,0.39,2,4,0.5,30,78,0.385,0.402,9,14,0.643,16,23,39,3,4,2,7,29,75,OOR
Stephon Marbury,PG,19,67,2324,355,871,0.408,102,288,0.354,253,583,0.434,0.466,245,337,0.727,54,130,184,522,67,19,210,159,1057,OOR
Šarūnas Marčiulionis,SG,32,17,255,38,101,0.376,11,30,0.367,27,71,0.38,0.431,29,36,0.806,12,18,30,25,12,1,40,38,116,OOR
Donny Marshall,SF,24,56,548,52,160,0.325,33,87,0.379,19,73,0.26,0.428,38,54,0.704,22,48,70,24,24,3,32,60,175,OOR
Donyell Marshall,SF,23,61,1022,174,421,0.413,35,111,0.315,139,310,0.448,0.455,61,98,0.622,92,184,276,54,25,46,55,96,444,OOR
Cuonzo Martin,SG,25,3,13,0,7,0.0,0,2,0.0,0,5,0.0,0.0,0,0,0.0,1,0,1,1,0,0,1,1,0,OOR
Darrick Martin,PG,25,82,1820,292,718,0.407,91,234,0.389,201,484,0.415,0.47,218,250,0.872,26,87,113,339,57,2,127,165,893,OOR
Jamal Mashburn,SF,24,69,2164,286,743,0.385,90,277,0.325,196,466,0.421,0.445,160,228,0.702,69,225,294,204,78,12,114,186,822,OOR
Anthony Mason,PF,30,73,3143,433,825,0.525,1,3,0.333,432,822,0.526,0.525,319,428,0.745,186,643,829,414,76,33,165,202,1186,OOR
Tony Massenburg,PF,29,79,1954,219,452,0.485,0,1,0.0,219,451,0.486,0.485,130,206,0.631,222,295,517,23,38,50,91,217,568,OOR
Vernon Maxwell,SG,31,72,2068,340,906,0.375,115,372,0.309,225,534,0.421,0.439,134,180,0.744,27,132,159,153,87,19,121,168,929,OOR
Lee Mayberry,PG,26,80,1952,149,370,0.403,83,221,0.376,66,149,0.443,0.515,29,46,0.63,29,105,134,329,60,8,90,159,410,OOR
Walter McCarty,PF,22,35,192,26,68,0.382,4,14,0.286,22,54,0.407,0.412,8,14,0.571,8,15,23,13,7,9,17,38,64,OOR
Amal McCaskill,C,23,17,109,10,32,0.313,0,2,0.0,10,30,0.333,0.313,8,12,0.667,4,18,22,7,3,5,11,7,28,OOR
George McCloud,SF,29,64,1493,238,578,0.412,99,254,0.39,139,324,0.429,0.497,83,101,0.822,36,143,179,109,61,8,61,126,658,OOR
Xavier McDaniel,PF,33,62,1170,138,355,0.389,5,25,0.2,133,330,0.403,0.396,65,89,0.73,124,194,318,65,36,17,70,144,346,OOR
Antonio McDyess,PF,22,74,2565,536,1157,0.463,6,35,0.171,530,1122,0.472,0.466,274,387,0.708,155,382,537,106,62,126,199,276,1352,OOR
Jim McIlvaine,C,24,82,1477,130,276,0.471,1,7,0.143,129,269,0.48,0.473,53,107,0.495,132,198,330,23,39,164,62,247,314,OOR
Jeff McInnis,PG,22,13,117,23,49,0.469,12,26,0.462,11,23,0.478,0.592,7,10,0.7,2,4,6,18,2,1,13,16,65,OOR
Derrick McKey,SF,30,50,1449,148,379,0.391,15,58,0.259,133,321,0.414,0.41,89,123,0.724,80,161,241,135,47,30,83,141,400,OOR
Aaron McKie,SG,24,83,1625,150,365,0.411,41,103,0.398,109,262,0.416,0.467,92,110,0.836,40,181,221,161,77,22,90,130,433,OOR
Nate McMillan,PG,32,37,798,61,149,0.409,28,84,0.333,33,65,0.508,0.503,19,29,0.655,15,103,118,140,58,6,32,78,169,OOR
Loren Meyer,PF,24,54,708,108,244,0.443,4,7,0.571,104,237,0.439,0.451,46,64,0.719,53,92,145,19,11,15,62,125,266,OOR
Anthony Miller,PF,25,1,14,0,5,0.0,0,0,0.0,0,5,0.0,0.0,0,0,0.0,2,5,7,0,0,0,0,2,0,OOR
Oliver Miller,C,26,61,1152,123,238,0.517,0,2,0.0,123,236,0.521,0.517,48,79,0.608,105,201,306,87,47,63,90,181,294,OOR
Reggie Miller,SG,31,81,2966,552,1244,0.444,229,536,0.427,323,708,0.456,0.536,418,475,0.88,53,233,286,273,75,25,166,172,1751,OOR
Chris Mills,SF,27,80,3167,405,894,0.453,86,220,0.391,319,674,0.473,0.501,176,209,0.842,118,379,497,198,86,41,120,222,1072,OOR
Terry Mills,PF,29,79,1997,312,702,0.444,175,415,0.422,137,287,0.477,0.569,58,70,0.829,68,309,377,99,35,27,85,161,857,OOR
Greg Minor,SF,25,23,547,94,196,0.48,1,8,0.125,93,188,0.495,0.482,31,36,0.861,30,50,80,34,15,2,22,45,220,OOR
Sam Mitchell,SF,33,82,2044,269,603,0.446,4,25,0.16,265,578,0.458,0.449,224,295,0.759,112,214,326,79,51,20,93,232,766,OOR
Eric Mobley,C,26,28,307,28,63,0.444,0,0,0.0,28,63,0.444,0.444,16,30,0.533,30,28,58,14,5,10,29,44,72,OOR
Eric Montross,C,25,78,1828,159,349,0.456,0,0,0.0,159,349,0.456,0.456,21,62,0.339,181,337,518,61,20,73,77,268,339,OOR
Tracy Moore,SG,31,27,237,33,85,0.388,11,43,0.256,22,42,0.524,0.453,22,31,0.71,11,15,26,20,5,0,14,19,99,OOR
Chris Morris,SF,31,73,977,122,299,0.408,31,113,0.274,91,186,0.489,0.46,39,54,0.722,37,125,162,43,29,24,45,121,314,OOR
Lawrence Moten,SG,24,67,1214,171,441,0.388,41,141,0.291,130,300,0.433,0.434,64,99,0.646,43,76,119,129,48,24,81,83,447,OOR
Alonzo Mourning,C,26,66,2320,473,885,0.534,1,9,0.111,472,876,0.539,0.535,363,565,0.642,189,467,656,104,56,189,226,272,1310,OOR
Chris Mullin,SF,33,79,2733,438,792,0.553,83,202,0.411,355,590,0.602,0.605,184,213,0.864,75,242,317,322,130,33,192,155,1143,OOR
Eric Murdock,PG,28,12,114,15,33,0.455,4,10,0.4,11,23,0.478,0.515,11,12,0.917,1,10,11,24,9,2,11,9,45,OOR
Gheorghe Mureșan,C,25,73,1849,327,541,0.604,0,0,0.0,327,541,0.604,0.604,123,199,0.618,141,340,481,29,43,96,117,230,777,OOR
Lamond Murray,SF,23,74,1295,181,435,0.416,31,91,0.341,150,344,0.436,0.452,156,211,0.739,85,148,233,57,53,29,86,113,549,OOR
Tracy Murray,SF,25,82,1814,288,678,0.425,106,300,0.353,182,378,0.481,0.503,135,161,0.839,84,169,253,78,69,19,86,150,817,OOR
Dikembe Mutombo,C,30,80,2973,380,721,0.527,0,0,0.0,380,721,0.527,0.527,306,434,0.705,268,661,929,110,49,264,186,249,1066,OOR
Martin Müürsepp,PF,22,42,348,54,131,0.412,4,24,0.167,50,107,0.467,0.427,44,70,0.629,35,32,67,20,12,11,18,58,156,OOR
Steve Nash,PG,22,65,684,74,175,0.423,23,55,0.418,51,120,0.425,0.489,42,51,0.824,16,47,63,138,20,0,63,92,213,OOR
Ruben Nembhard,SG-PG,24,10,113,16,37,0.432,0,6,0.0,16,31,0.516,0.432,8,10,0.8,3,5,8,17,9,0,8,12,40,OOR
Ivano Newbill,PF,26,72,850,40,91,0.44,0,0,0.0,40,91,0.44,0.44,20,52,0.385,76,128,204,24,28,15,42,115,100,OOR
Johnny Newman,SF,33,82,2060,246,547,0.45,34,98,0.347,212,449,0.472,0.481,189,247,0.765,66,120,186,116,73,17,115,257,715,OOR
Gaylon Nickerson,SG,27,4,42,4,12,0.333,0,2,0.0,4,10,0.4,0.333,7,7,1.0,1,4,5,1,1,1,1,1,15,OOR
Ken Norman,SF,32,17,220,27,94,0.287,6,38,0.158,21,56,0.375,0.319,4,12,0.333,8,31,39,12,7,3,18,17,64,OOR
Moochie Norris,PG,23,8,89,4,22,0.182,2,10,0.2,2,12,0.167,0.227,2,5,0.4,3,9,12,23,4,0,5,5,12,OOR
Ed O'Bannon,SF,24,64,809,93,279,0.333,18,70,0.257,75,209,0.359,0.366,31,35,0.886,50,98,148,39,29,12,20,97,235,OOR
Jermaine O'Neal,PF,18,45,458,69,153,0.451,0,1,0.0,69,152,0.454,0.451,47,78,0.603,39,85,124,8,2,26,27,46,185,OOR
Shaquille O'Neal,C,24,51,1941,552,991,0.557,0,4,0.0,552,987,0.559,0.557,232,479,0.484,195,445,640,159,46,147,146,180,1336,OOR
Charles Oakley,PF,33,80,2873,339,694,0.488,5,19,0.263,334,675,0.495,0.492,181,224,0.808,246,535,781,221,111,21,171,305,864,OOR
Hakeem Olajuwon,C,34,78,2852,727,1426,0.51,5,16,0.313,722,1410,0.512,0.512,351,446,0.787,173,543,716,236,117,173,281,249,1810,OOR
Jimmy Oliver,SG,27,4,43,4,13,0.308,1,6,0.167,3,7,0.429,0.346,2,2,1.0,1,4,5,1,2,0,3,2,11,OOR
Greg Ostertag,C,23,77,1818,210,408,0.515,0,4,0.0,210,404,0.52,0.515,139,205,0.678,180,385,565,27,24,152,74,233,559,OOR
Bo Outlaw,PF,25,82,2195,254,417,0.609,0,8,0.0,254,409,0.621,0.609,117,232,0.504,174,280,454,157,94,142,107,227,625,OOR
Doug Overton,PG,27,61,634,81,190,0.426,10,40,0.25,71,150,0.473,0.453,45,48,0.938,18,50,68,101,24,0,39,44,217,OOR
Billy Owens,SF,27,66,1995,299,640,0.467,25,72,0.347,274,568,0.482,0.487,101,145,0.697,134,258,392,187,62,25,133,187,724,OOR
Ray Owes,PF,24,57,592,75,180,0.417,1,5,0.2,74,175,0.423,0.419,26,46,0.565,64,99,163,15,15,20,23,86,177,OOR
Robert Pack,PG,27,54,1782,272,693,0.392,31,112,0.277,241,581,0.415,0.415,196,243,0.807,28,118,146,452,94,6,217,139,771,OOR
Robert Parish,C,43,43,406,70,143,0.49,0,0,0.0,70,143,0.49,0.49,21,31,0.677,42,47,89,22,6,19,28,40,161,OOR
Cherokee Parks,PF,24,76,961,103,202,0.51,0,1,0.0,103,201,0.512,0.51,46,76,0.605,83,112,195,34,41,48,32,150,252,OOR
Gary Payton,PG,28,82,3213,706,1482,0.476,119,380,0.313,587,1102,0.533,0.517,254,355,0.715,106,272,378,583,197,13,215,208,1785,OOR
Anthony Peeler,SG,27,72,2291,402,1011,0.398,128,343,0.373,274,668,0.41,0.461,109,133,0.82,54,193,247,256,105,17,157,168,1041,OOR
Will Perdue,C,31,65,1918,233,410,0.568,0,0,0.0,233,410,0.568,0.568,99,171,0.579,251,387,638,38,32,102,87,184,565,OOR
Sam Perkins,C,35,81,1976,290,661,0.439,122,309,0.395,168,352,0.477,0.531,187,229,0.817,74,226,300,103,69,49,77,134,889,OOR
Elliot Perry,PG,27,82,1595,217,458,0.474,49,137,0.358,168,321,0.523,0.527,79,106,0.745,24,100,124,247,98,3,111,117,562,OOR
Wesley Person,SG,25,80,2326,409,903,0.453,171,414,0.413,238,489,0.487,0.548,91,114,0.798,68,224,292,123,86,20,76,102,1080,OOR
Bobby Phills,SG,27,69,2375,328,766,0.428,85,216,0.394,243,550,0.442,0.484,125,174,0.718,63,182,245,233,113,21,135,174,866,OOR
Eric Piatkowski,SG,26,65,747,134,298,0.45,51,120,0.425,83,178,0.466,0.535,69,84,0.821,49,56,105,52,33,10,46,85,388,OOR
Ricky Pierce,SG,37,60,1250,239,497,0.481,42,95,0.442,197,402,0.49,0.523,139,155,0.897,36,85,121,80,28,9,68,97,659,OOR
Ed Pinckney,PF,33,27,273,23,43,0.535,0,0,0.0,23,43,0.535,0.535,20,25,0.8,25,40,65,6,8,9,19,30,66,OOR
Scottie Pippen,SF,31,82,3095,648,1366,0.474,156,424,0.368,492,942,0.522,0.531,204,291,0.701,160,371,531,467,154,45,214,213,1656,OOR
Olden Polynice,C,32,82,2893,442,967,0.457,0,6,0.0,442,961,0.46,0.457,141,251,0.562,272,500,772,178,46,80,166,298,1025,OOR
Terry Porter,PG,33,82,1568,187,449,0.416,67,200,0.335,120,249,0.482,0.491,127,166,0.765,31,145,176,295,54,11,128,104,568,OOR
Vitaly Potapenko,C,21,80,1238,186,423,0.44,1,2,0.5,185,421,0.439,0.441,92,125,0.736,105,112,217,40,26,34,109,216,465,OOR
Brent Price,PG,28,25,390,44,105,0.419,17,53,0.321,27,52,0.519,0.5,21,21,1.0,10,19,29,65,17,0,32,34,126,OOR
Mark Price,PG,32,70,1876,263,589,0.447,112,283,0.396,151,306,0.493,0.542,155,171,0.906,36,143,179,342,67,3,161,100,793,OOR
Dino Radja,C,29,25,874,149,339,0.44,0,1,0.0,149,338,0.441,0.44,51,71,0.718,44,167,211,48,23,48,70,76,349,OOR
Theo Ratliff,C,23,76,1292,179,337,0.531,0,0,0.0,179,337,0.531,0.531,81,116,0.698,109,147,256,13,29,111,56,181,439,OOR
Eldridge Recasner,SG,29,71,1207,148,350,0.423,58,140,0.414,90,210,0.429,0.506,51,58,0.879,35,80,115,94,38,4,65,97,405,OOR
Bryant Reeves,C,23,75,2777,498,1025,0.486,1,11,0.091,497,1014,0.49,0.486,216,307,0.704,174,436,610,160,29,67,175,270,1213,OOR
Khalid Reeves,PG,24,63,1432,184,470,0.391,83,227,0.366,101,243,0.416,0.48,65,87,0.747,34,85,119,226,34,9,108,159,516,OOR
Don Reid,PF,23,47,462,54,112,0.482,0,1,0.0,54,111,0.486,0.482,24,32,0.75,36,65,101,14,16,15,23,105,132,OOR
Shawn Respert,SG,24,41,495,59,139,0.424,20,57,0.351,39,82,0.476,0.496,34,39,0.872,14,25,39,40,20,2,30,40,172,OOR
Glen Rice,SF,29,79,3362,722,1513,0.477,207,440,0.47,515,1073,0.48,0.546,464,535,0.867,67,251,318,160,72,26,177,190,2115,Candidate
Pooh Richardson,PG,30,59,1065,131,344,0.381,42,128,0.328,89,216,0.412,0.442,26,43,0.605,25,73,98,169,54,5,62,82,330,OOR
Mitch Richmond,SG,31,81,3125,717,1578,0.454,204,477,0.428,513,1101,0.466,0.519,457,531,0.861,59,260,319,338,118,24,237,211,2095,OOR
Isaiah Rider,SG,25,76,2563,456,983,0.464,99,257,0.385,357,726,0.492,0.514,212,261,0.812,94,210,304,198,45,19,212,199,1223,OOR
Fred Roberts,PF,36,12,40,6,15,0.4,0,0,0.0,6,15,0.4,0.4,10,14,0.714,2,8,10,0,0,1,5,2,22,OOR
Stanley Roberts,C,26,18,378,63,148,0.426,0,0,0.0,63,148,0.426,0.426,45,64,0.703,24,67,91,9,8,23,23,57,171,OOR
Chris Robinson,SG,22,41,681,69,182,0.379,34,89,0.382,35,93,0.376,0.473,16,26,0.615,23,48,71,65,28,9,34,85,188,OOR
Clifford Robinson,SF,30,81,3077,444,1043,0.426,121,350,0.346,323,693,0.466,0.484,215,309,0.696,90,231,321,261,99,66,172,251,1224,OOR
David Robinson,C,31,6,147,36,72,0.5,0,0,0.0,36,72,0.5,0.5,34,52,0.654,19,32,51,8,6,6,8,9,106,OOR
Glenn Robinson,SF,24,80,3114,669,1438,0.465,63,180,0.35,606,1258,0.482,0.487,288,364,0.791,130,372,502,248,103,68,269,225,1689,OOR
James Robinson,PG,26,69,1309,196,482,0.407,102,267,0.382,94,215,0.437,0.512,78,114,0.684,24,88,112,126,30,8,69,125,572,OOR
Rumeal Robinson,PG,30,54,508,66,164,0.402,18,56,0.321,48,108,0.444,0.457,26,35,0.743,6,41,47,73,24,2,43,60,176,OOR
Dennis Rodman,PF,35,55,1947,128,286,0.448,5,19,0.263,123,267,0.461,0.456,50,88,0.568,320,563,883,170,32,19,111,172,311,OOR
Lou Roe,SF,24,17,107,14,48,0.292,3,11,0.273,11,37,0.297,0.323,9,19,0.474,7,7,14,6,3,1,11,10,40,OOR
Carlos Rogers,PF,25,56,1397,212,404,0.525,25,66,0.379,187,338,0.553,0.556,102,170,0.6,120,184,304,37,42,69,53,140,551,OOR
Rodney Rogers,SF,25,81,2480,408,884,0.462,65,180,0.361,343,704,0.487,0.498,191,288,0.663,137,274,411,222,88,61,221,272,1072,OOR
Roy Rogers,PF,23,82,1848,244,483,0.505,1,1,1.0,243,482,0.504,0.506,54,94,0.574,139,247,386,46,21,163,86,214,543,OOR
Sean Rooks,C,27,69,735,87,185,0.47,0,1,0.0,87,184,0.473,0.47,91,130,0.7,56,107,163,42,17,38,51,123,265,OOR
Jalen Rose,SF,24,66,1188,172,377,0.456,21,72,0.292,151,305,0.495,0.484,117,156,0.75,27,94,121,155,57,18,107,136,482,OOR
Malik Rose,PF,22,54,525,61,128,0.477,0,2,0.0,61,126,0.484,0.477,38,62,0.613,70,94,164,32,28,17,41,114,160,OOR
Donald Royal,SF,30,62,858,62,146,0.425,0,2,0.0,62,144,0.431,0.425,94,117,0.803,52,102,154,25,23,11,47,100,218,OOR
Clifford Rozier,C,24,42,737,79,174,0.454,0,2,0.0,79,172,0.459,0.454,31,61,0.508,102,132,234,31,24,44,29,97,189,OOR
Bryon Russell,SF,26,81,2525,297,620,0.479,108,264,0.409,189,356,0.531,0.566,171,244,0.701,79,252,331,123,129,27,94,237,873,OOR
Arvydas Sabonis,C,32,69,1762,328,658,0.498,49,132,0.371,279,526,0.53,0.536,223,287,0.777,114,433,547,146,63,84,151,203,928,OOR
Kevin Salvadori,C,26,23,154,12,33,0.364,0,0,0.0,12,33,0.364,0.364,13,18,0.722,6,19,25,10,2,13,12,17,37,OOR
Jason Sasser,SF,23,8,69,9,23,0.391,1,3,0.333,8,20,0.4,0.413,0,0,0.0,1,7,8,2,3,0,2,11,19,OOR
Danny Schayes,PF,37,45,540,47,120,0.392,0,1,0.0,47,119,0.395,0.392,39,52,0.75,41,84,125,14,15,16,27,74,133,OOR
Steve Scheffler,C,29,7,29,6,7,0.857,0,0,0.0,6,7,0.857,0.857,1,2,0.5,1,2,3,0,0,0,5,5,13,OOR
Dwayne Schintzius,C,28,15,116,13,36,0.361,1,2,0.5,12,34,0.353,0.375,7,8,0.875,9,13,22,4,1,9,7,22,34,OOR
Detlef Schrempf,SF,34,61,2192,356,724,0.492,57,161,0.354,299,563,0.531,0.531,253,316,0.801,87,307,394,266,63,16,150,151,1022,OOR
Brent Scott,PF,25,16,55,8,17,0.471,0,0,0.0,8,17,0.471,0.471,3,6,0.5,3,6,9,3,1,1,4,14,19,OOR
Byron Scott,SG,35,79,1440,163,379,0.43,73,188,0.388,90,191,0.471,0.526,127,151,0.841,21,97,118,99,46,16,53,72,526,OOR
Dennis Scott,SF,28,66,2166,298,749,0.398,147,373,0.394,151,376,0.402,0.496,80,101,0.792,40,163,203,139,74,19,81,138,823,OOR
James Scott,SF,24,8,32,0,8,0.0,0,4,0.0,0,4,0.0,0.0,1,2,0.5,1,5,6,3,2,0,2,5,1,OOR
Shawnelle Scott,C,24,16,50,8,16,0.5,0,0,0.0,8,16,0.5,0.5,4,11,0.364,8,8,16,0,0,3,0,6,20,OOR
Malik Sealy,SG,26,80,2456,373,942,0.396,79,222,0.356,294,720,0.408,0.438,254,290,0.876,59,179,238,165,124,45,154,185,1079,OOR
Rony Seikaly,C,31,74,2615,460,907,0.507,0,3,0.0,460,904,0.509,0.507,357,500,0.714,274,427,701,92,49,107,218,275,1277,OOR
Brian Shaw,PG,30,77,1867,189,516,0.366,63,194,0.325,126,322,0.391,0.427,111,140,0.793,47,147,194,319,67,26,170,197,552,OOR
Lionel Simmons,SF,28,41,521,45,136,0.331,7,30,0.233,38,106,0.358,0.357,42,48,0.875,30,74,104,57,8,13,34,63,139,OOR
Dickey Simpkins,PF,24,48,395,31,93,0.333,1,4,0.25,30,89,0.337,0.339,28,40,0.7,36,56,92,31,5,5,35,44,91,OOR
Reggie Slater,PF,26,26,406,82,149,0.55,0,2,0.0,82,147,0.558,0.55,39,75,0.52,40,55,95,21,9,6,29,34,203,OOR
Charles Smith,PF,31,19,329,34,84,0.405,0,1,0.0,34,83,0.41,0.405,20,26,0.769,18,47,65,14,13,22,22,44,88,OOR
Joe Smith,PF,21,80,3086,587,1293,0.454,12,46,0.261,575,1247,0.461,0.459,307,377,0.814,261,418,679,125,74,86,192,244,1493,OOR
Kenny Smith,PG,31,48,765,101,239,0.423,59,135,0.437,42,104,0.404,0.546,39,45,0.867,4,40,44,116,19,0,71,30,300,OOR
Michael Smith,PF,24,81,2526,202,375,0.539,0,0,0.0,202,375,0.539,0.539,128,258,0.496,257,512,769,191,82,60,130,251,532,OOR
Steve Smith,SG,27,72,2818,491,1145,0.429,130,388,0.335,361,757,0.477,0.486,333,393,0.847,90,148,238,305,62,23,176,173,1445,OOR
Stevin Smith,SG,25,8,60,6,18,0.333,1,6,0.167,5,12,0.417,0.361,1,1,1.0,2,8,10,4,1,0,4,9,14,OOR
Tony Smith,PG,28,69,1291,138,337,0.409,32,99,0.323,106,238,0.445,0.457,38,59,0.644,38,56,94,150,48,19,73,110,346,OOR
Rik Smits,C,30,52,1518,356,733,0.486,2,8,0.25,354,725,0.488,0.487,173,217,0.797,105,256,361,67,22,59,126,175,887,OOR
Eric Snow,PG,23,67,775,74,164,0.451,4,15,0.267,70,149,0.47,0.463,47,66,0.712,17,53,70,159,37,3,48,94,199,OOR
Elmore Spencer,C,27,1,5,0,1,0.0,0,0,0.0,0,1,0.0,0.0,0,0,0.0,0,0,0,0,1,0,1,0,0,OOR
Felton Spencer,C,29,73,1558,139,284,0.489,0,0,0.0,139,284,0.489,0.489,94,161,0.584,157,259,416,22,34,50,88,275,372,OOR
Latrell Sprewell,SG,26,80,3353,649,1444,0.449,147,415,0.354,502,1029,0.488,0.5,493,585,0.843,58,308,366,507,132,45,322,153,1938,OOR
Jerry Stackhouse,SG,22,81,3166,533,1308,0.407,102,342,0.298,431,966,0.446,0.446,511,667,0.766,156,182,338,253,93,63,316,219,1679,OOR
John Starks,SG,31,77,2042,369,856,0.431,150,407,0.369,219,449,0.488,0.519,173,225,0.769,36,169,205,217,90,11,158,196,1061,OOR
Matt Steigenga,SF,26,2,12,1,4,0.25,0,2,0.0,1,2,0.5,0.25,1,2,0.5,0,3,3,2,1,1,2,1,3,OOR
Joe Stephens,PF,24,2,9,1,5,0.2,1,3,0.333,0,2,0.0,0.3,0,0,0.0,2,1,3,0,3,0,3,3,3,OOR
Larry Stewart,SF,28,70,982,112,252,0.444,9,37,0.243,103,215,0.479,0.462,67,93,0.72,75,96,171,52,31,23,63,108,300,OOR
Bryant Stith,SG,26,52,1788,251,603,0.416,70,182,0.385,181,421,0.43,0.474,202,234,0.863,74,143,217,133,60,20,101,119,774,OOR
John Stockton,PG,34,82,2896,416,759,0.548,76,180,0.422,340,579,0.587,0.598,275,325,0.846,45,183,228,860,166,15,248,194,1183,OOR
Damon Stoudamire,PG,23,81,3311,564,1407,0.401,176,496,0.355,388,911,0.426,0.463,330,401,0.823,86,244,330,709,123,13,288,162,1634,OOR
Erick Strickland,SG,23,28,759,102,256,0.398,28,92,0.304,74,164,0.451,0.453,65,80,0.813,21,69,90,68,27,5,66,75,297,OOR
Mark Strickland,PF,26,31,153,25,60,0.417,0,1,0.0,25,59,0.424,0.417,12,21,0.571,16,21,37,1,4,10,15,17,62,OOR
Rod Strickland,PG,30,82,2997,515,1105,0.466,13,77,0.169,502,1028,0.488,0.472,367,497,0.738,95,240,335,727,143,14,270,166,1410,OOR
Derek Strong,PF,28,82,2004,262,586,0.447,0,13,0.0,262,573,0.457,0.447,175,218,0.803,174,345,519,73,47,20,102,196,699,OOR
Bob Sura,SG,23,82,2269,253,587,0.431,53,164,0.323,200,423,0.473,0.476,196,319,0.614,76,232,308,390,90,33,181,218,755,OOR
Brett Szabo,C,28,70,662,54,121,0.446,0,1,0.0,54,120,0.45,0.446,45,61,0.738,56,109,165,17,16,32,41,119,153,OOR
Žan Tabak,C,26,13,218,32,71,0.451,0,0,0.0,32,71,0.451,0.451,20,29,0.69,20,29,49,14,6,11,21,35,84,OOR
Carl Thomas,SG,27,19,77,9,24,0.375,2,12,0.167,7,12,0.583,0.417,1,1,1.0,3,10,13,8,2,1,6,7,21,OOR
Kurt Thomas,PF,24,18,374,39,105,0.371,0,1,0.0,39,104,0.375,0.371,35,46,0.761,31,76,107,9,12,9,25,67,113,OOR
Brooks Thompson,PG,26,67,1055,162,406,0.399,97,244,0.398,65,162,0.401,0.518,24,38,0.632,18,78,96,180,55,2,87,126,445,OOR
LaSalle Thompson,C,35,26,140,3,19,0.158,0,0,0.0,3,19,0.158,0.158,4,6,0.667,7,27,34,2,3,6,9,33,10,OOR
Otis Thorpe,C,34,79,2661,419,787,0.532,0,2,0.0,419,785,0.534,0.532,198,303,0.653,226,396,622,133,59,17,145,298,1036,OOR
Sedale Threatt,SG,35,21,334,28,74,0.378,8,20,0.4,20,54,0.37,0.432,6,8,0.75,5,19,24,40,15,3,13,29,70,OOR
Wayman Tisdale,PF,32,53,778,158,371,0.426,0,0,0.0,158,371,0.426,0.426,30,48,0.625,35,85,120,20,8,21,36,111,346,OOR
Keith Tower,C,26,5,72,3,8,0.375,0,0,0.0,3,8,0.375,0.375,1,8,0.125,2,7,9,1,2,1,2,12,7,OOR
Gary Trent,PF,22,82,1918,361,674,0.536,0,11,0.0,361,663,0.544,0.536,160,229,0.699,156,272,428,87,48,35,129,186,882,OOR
Nick Van Exel,PG,25,79,2937,432,1075,0.402,177,468,0.378,255,607,0.42,0.484,165,200,0.825,44,182,226,672,75,10,212,110,1206,OOR
David Vaughn,PF,23,35,298,31,72,0.431,0,0,0.0,31,72,0.431,0.431,19,30,0.633,35,60,95,7,8,15,29,43,81,OOR
Loy Vaught,PF,28,82,2838,542,1084,0.5,2,12,0.167,540,1072,0.504,0.501,134,191,0.702,222,595,817,110,85,25,137,241,1220,OOR
Stojko Vranković,C,33,53,766,78,139,0.561,0,0,0.0,78,139,0.561,0.561,25,37,0.676,57,111,168,14,10,67,52,121,181,OOR
Antoine Walker,PF,20,82,2970,576,1354,0.425,52,159,0.327,524,1195,0.438,0.445,231,366,0.631,288,453,741,262,105,53,230,271,1435,OOR
Samaki Walker,PF,20,43,602,83,187,0.444,0,1,0.0,83,186,0.446,0.444,48,74,0.649,47,100,147,17,15,22,39,71,214,OOR
Ben Wallace,PF,22,34,197,16,46,0.348,0,0,0.0,16,46,0.348,0.348,6,20,0.3,25,33,58,2,8,11,18,27,38,OOR
John Wallace,SF,22,68,787,122,236,0.517,2,4,0.5,120,232,0.517,0.521,79,110,0.718,51,104,155,37,21,25,76,102,325,OOR
Rasheed Wallace,PF,22,62,1892,380,681,0.558,9,33,0.273,371,648,0.573,0.565,169,265,0.638,122,297,419,74,48,59,114,198,938,OOR
Rex Walters,SG,26,59,1041,148,325,0.455,57,148,0.385,91,177,0.514,0.543,49,62,0.79,21,86,107,113,28,3,61,75,402,OOR
Charlie Ward,PG,26,79,1763,133,337,0.395,48,154,0.312,85,183,0.464,0.466,95,125,0.76,45,175,220,326,83,15,147,188,409,OOR
Jamie Watson,SF,24,23,340,31,72,0.431,4,12,0.333,27,60,0.45,0.458,12,16,0.75,18,29,47,33,22,4,24,34,78,OOR
Clarence Weatherspoon,SF,26,82,2949,398,811,0.491,1,6,0.167,397,805,0.493,0.491,206,279,0.738,219,460,679,140,74,86,137,187,1003,OOR
Chris Webber,PF,23,72,2806,604,1167,0.518,60,151,0.397,544,1016,0.535,0.543,177,313,0.565,238,505,743,331,122,137,230,258,1445,OOR
Bill Wennington,C,33,61,783,118,237,0.498,0,2,0.0,118,235,0.502,0.498,44,53,0.83,46,83,129,41,10,11,31,132,280,OOR
Robert Werdann,C,26,6,31,3,7,0.429,0,0,0.0,3,7,0.429,0.429,3,3,1.0,3,3,6,0,2,1,2,10,9,OOR
David Wesley,PG,26,74,2991,456,974,0.468,103,286,0.36,353,688,0.513,0.521,225,288,0.781,67,197,264,537,162,13,211,221,1240,OOR
Doug West,SG,29,68,1920,226,484,0.467,15,45,0.333,211,439,0.481,0.482,64,94,0.681,37,111,148,113,61,24,66,218,531,OOR
Mark West,C,36,70,959,100,180,0.556,0,0,0.0,100,180,0.556,0.556,27,56,0.482,69,117,186,19,11,55,52,142,227,OOR
Ennis Whatley,PG,34,3,22,2,4,0.5,0,0,0.0,2,4,0.5,0.5,0,0,0.0,0,3,3,3,0,0,1,5,4,OOR
Donald Whiteside,PG,27,27,259,18,55,0.327,12,36,0.333,6,19,0.316,0.436,11,15,0.733,2,10,12,36,11,0,17,23,59,OOR
Chris Whitney,PG,25,82,1117,139,330,0.421,58,163,0.356,81,167,0.485,0.509,94,113,0.832,13,91,104,182,49,4,68,100,430,OOR
Dominique Wilkins,SF,37,63,1945,397,953,0.417,70,239,0.293,327,714,0.458,0.453,281,350,0.803,169,233,402,119,39,31,135,100,1145,OOR
Gerald Wilkins,SG,33,80,2202,323,759,0.426,66,203,0.325,257,556,0.462,0.469,136,190,0.716,59,114,173,173,54,12,123,144,848,OOR
Aaron Williams,PF-C,25,33,563,85,148,0.574,0,1,0.0,85,147,0.578,0.574,33,49,0.673,62,81,143,15,16,29,32,72,203,OOR
Buck Williams,PF,36,74,1496,175,326,0.537,0,1,0.0,175,325,0.538,0.537,115,179,0.642,166,231,397,53,40,38,79,204,465,OOR
Eric Williams,SG,24,72,2435,374,820,0.456,2,8,0.25,372,812,0.458,0.457,328,436,0.752,126,203,329,129,72,13,139,213,1078,OOR
Herb Williams,PF,38,21,184,18,46,0.391,0,1,0.0,18,45,0.4,0.391,3,4,0.75,9,22,31,5,4,5,5,18,39,OOR
Hot Rod Williams,C,34,68,2137,204,416,0.49,0,2,0.0,204,414,0.493,0.49,133,198,0.672,178,384,562,100,67,88,66,176,541,OOR
Jayson Williams,PF,28,41,1432,221,540,0.409,0,4,0.0,221,536,0.412,0.409,108,183,0.59,242,311,553,51,24,36,82,158,550,OOR
Jerome Williams,PF,23,33,177,20,51,0.392,0,0,0.0,20,51,0.392,0.392,9,17,0.529,22,28,50,7,13,1,13,18,49,OOR
Lorenzo Williams,C,27,19,264,20,31,0.645,0,0,0.0,20,31,0.645,0.645,5,7,0.714,28,41,69,4,6,8,18,49,45,OOR
Monty Williams,SF,25,65,1345,234,460,0.509,0,1,0.0,234,459,0.51,0.509,120,186,0.645,98,108,206,91,55,52,116,161,588,OOR
Reggie Williams,SF,32,13,200,29,76,0.382,9,34,0.265,20,42,0.476,0.441,9,12,0.75,5,26,31,10,8,4,12,33,76,OOR
Scott Williams,C,28,62,1317,162,318,0.509,0,2,0.0,162,316,0.513,0.509,38,55,0.691,155,242,397,41,44,41,50,206,362,OOR
Walt Williams,SF,26,73,2647,419,982,0.427,175,437,0.4,244,545,0.448,0.516,186,243,0.765,103,264,367,197,97,62,174,282,1199,OOR
Corliss Williamson,SF,23,79,1992,371,745,0.498,0,3,0.0,371,742,0.5,0.498,173,251,0.689,139,187,326,124,60,49,157,263,915,OOR
Kevin Willis,PF,34,75,1964,350,728,0.481,2,14,0.143,348,714,0.487,0.482,140,202,0.693,146,415,561,71,42,32,119,216,842,OOR
David Wingate,SG,33,65,929,89,214,0.416,25,71,0.352,64,143,0.448,0.474,33,40,0.825,23,51,74,80,44,5,37,108,236,OOR
Dontonio Wingfield,SF,22,47,569,79,193,0.409,26,77,0.338,53,116,0.457,0.477,27,40,0.675,63,74,137,45,14,6,49,101,211,OOR
Joe Wolf,C,32,56,525,40,89,0.449,1,7,0.143,39,82,0.476,0.455,14,19,0.737,32,80,112,20,14,11,14,105,95,OOR
David Wood,PF,32,46,240,20,38,0.526,5,15,0.333,15,23,0.652,0.592,12,18,0.667,5,22,27,13,7,6,6,36,57,OOR
Haywoode Workman,PG,31,4,81,11,20,0.55,0,3,0.0,11,17,0.647,0.55,0,1,0.0,4,3,7,11,3,0,5,10,22,OOR
Lorenzen Wright,C,21,77,1936,236,491,0.481,1,4,0.25,235,487,0.483,0.482,88,150,0.587,206,265,471,49,48,60,79,211,561,OOR
Sharone Wright,C,24,60,1009,161,403,0.4,0,1,0.0,161,402,0.4,0.4,68,133,0.511,79,107,186,28,15,50,93,146,390,OOR
George Zídek,C,23,52,376,49,118,0.415,0,2,0.0,49,116,0.422,0.415,45,57,0.789,35,51,86,14,5,3,27,61,143,OOR
Aleksandar Djordjevic,SG,29,8,61,8,16,0.5,5,7,0.714,3,9,0.333,0.656,4,5,0.8,1,4,5,5,0,0,5,3,25,OOR
