Player,Pos,Age,G,MP,FG,FGA,FG%,3P,3PA,3P%,2P,2PA,2P%,eFG%,FT,FTA,FT%,ORB,DRB,TRB,AST,STL,BLK,TOV,PF,PTS,Status
Tariq Abdul-Wahad,SG,24,49,1205,177,407,0.435,6,21,0.286,171,386,0.443,0.442,94,136,0.691,72,114,186,50,50,16,70,121,454,OOR
Shareef Abdur-Rahim,SF,22,50,2021,386,893,0.432,11,36,0.306,375,857,0.438,0.438,369,439,0.841,114,260,374,172,69,55,186,137,1152,OOR
Cory Alexander,PG,25,36,778,97,260,0.373,30,105,0.286,67,155,0.432,0.431,37,44,0.841,7,67,74,119,35,5,69,77,261,OOR
Ray Allen,SG,23,50,1719,303,673,0.45,74,208,0.356,229,465,0.492,0.505,176,195,0.903,57,155,212,178,53,7,122,117,856,OOR
Peter Aluma,C,25,2,5,1,2,0.5,0,0,0.0,1,2,0.5,0.5,0,0,0.0,1,1,2,0,1,1,2,4,2,OOR
Derek Anderson,SG,24,38,978,125,314,0.398,21,69,0.304,104,245,0.424,0.432,138,165,0.836,20,89,109,145,48,4,82,73,409,OOR
Kenny Anderson,PG,28,34,1010,161,357,0.451,6,24,0.25,155,333,0.465,0.459,84,101,0.832,24,79,103,193,33,2,71,78,412,OOR
Nick Anderson,SF,31,47,1581,253,640,0.395,96,277,0.347,157,363,0.433,0.47,99,162,0.611,51,226,277,91,64,15,83,72,701,OOR
Shandon Anderson,SG,25,50,1072,162,363,0.446,14,41,0.341,148,322,0.46,0.466,89,125,0.712,49,83,132,56,39,10,66,89,427,OOR
Chris Anstey,C,24,41,470,50,139,0.36,0,7,0.0,50,132,0.379,0.36,34,48,0.708,35,62,97,27,18,13,26,98,134,OOR
Greg Anthony,PG,31,50,806,104,251,0.414,49,125,0.392,55,126,0.437,0.512,62,89,0.697,14,49,63,100,66,3,55,75,319,OOR
B.J. Armstrong,PG,31,32,358,40,88,0.455,7,15,0.467,33,73,0.452,0.494,18,21,0.857,2,37,39,61,12,0,25,31,105,OOR
Darrell Armstrong,PG,30,50,1502,230,522,0.441,69,189,0.365,161,333,0.483,0.507,161,178,0.904,53,127,180,335,108,4,158,90,690,OOR
Keith Askins,SF,31,33,415,20,62,0.323,8,29,0.276,12,33,0.364,0.387,5,8,0.625,10,34,44,10,17,3,13,58,53,OOR
Stacey Augmon,SF,30,48,874,78,174,0.448,0,2,0.0,78,172,0.453,0.448,52,76,0.684,47,78,125,58,57,18,30,81,208,OOR
Isaac Austin,C,29,49,1259,185,453,0.408,2,7,0.286,183,446,0.41,0.411,105,157,0.669,83,154,237,89,47,35,114,125,477,OOR
Anthony Avent,PF,29,5,44,4,13,0.308,0,0,0.0,4,13,0.308,0.308,1,2,0.5,8,4,12,1,2,0,7,6,9,OOR
Thurl Bailey,PF,37,43,543,78,175,0.446,0,2,0.0,78,173,0.451,0.446,25,34,0.735,36,58,94,26,9,28,27,78,181,OOR
Toby Bailey,SG,23,27,249,34,86,0.395,1,5,0.2,33,81,0.407,0.401,9,13,0.692,24,30,54,13,9,2,11,24,78,OOR
Mark Baker,PG,29,1,2,0,1,0.0,0,0,0.0,0,1,0.0,0.0,0,0,0.0,0,0,0,0,0,0,1,0,0,OOR
Vin Baker,PF,27,34,1162,198,437,0.453,0,3,0.0,198,434,0.456,0.453,72,160,0.45,86,125,211,56,32,34,76,121,468,OOR
Charles Barkley,PF,35,42,1526,240,502,0.478,4,25,0.16,236,477,0.495,0.482,192,267,0.719,167,349,516,192,43,13,100,89,676,OOR
Dana Barros,PG,31,50,1156,168,371,0.453,64,160,0.4,104,211,0.493,0.539,64,73,0.877,16,89,105,208,52,5,88,64,464,OOR
Brent Barry,SG,27,37,1181,141,356,0.396,52,172,0.302,89,184,0.484,0.469,78,101,0.772,39,105,144,116,42,11,72,98,412,OOR
Drew Barry,SG,25,17,183,10,32,0.313,8,24,0.333,2,8,0.25,0.438,9,13,0.692,3,17,20,29,7,1,12,24,37,OOR
Jon Barry,SG,29,43,736,59,138,0.428,24,79,0.304,35,59,0.593,0.514,71,84,0.845,25,71,96,112,53,5,47,61,213,OOR
Tony Battie,C,22,50,1121,147,283,0.519,0,3,0.0,147,280,0.525,0.519,41,61,0.672,96,204,300,53,29,71,45,159,335,OOR
Corey Beck,PG,27,24,180,18,39,0.462,1,1,1.0,17,38,0.447,0.474,8,15,0.533,6,22,28,20,9,2,13,26,45,OOR
Benoit Benjamin,C,34,6,33,2,7,0.286,0,0,0.0,2,7,0.286,0.286,0,0,0.0,3,5,8,1,0,0,3,6,4,OOR
Corey Benjamin,PG,20,31,320,44,117,0.376,3,14,0.214,41,103,0.398,0.389,27,40,0.675,15,25,40,10,11,8,21,46,118,OOR
Mario Bennett,PF,25,3,19,2,6,0.333,0,0,0.0,2,6,0.333,0.333,3,4,0.75,2,3,5,0,1,0,1,4,7,OOR
Travis Best,PG,26,49,1043,127,305,0.416,22,59,0.373,105,246,0.427,0.452,70,83,0.843,19,61,80,169,42,4,62,111,346,OOR
Mike Bibby,PG,20,50,1758,260,605,0.43,15,74,0.203,245,531,0.461,0.442,127,169,0.751,30,106,136,325,78,5,146,122,662,OOR
Chauncey Billups,SG,22,45,1488,191,495,0.386,85,235,0.362,106,260,0.408,0.472,157,172,0.913,24,72,96,173,58,14,98,115,624,OOR
Mookie Blaylock,PG,31,48,1763,247,651,0.379,77,251,0.307,170,400,0.425,0.439,69,91,0.758,45,179,224,278,99,9,115,61,640,OOR
Corie Blount,PF,30,34,530,36,100,0.36,0,1,0.0,36,99,0.364,0.36,28,54,0.519,58,93,151,12,19,16,21,74,100,OOR
Muggsy Bogues,PG,34,36,714,76,154,0.494,0,6,0.0,76,148,0.514,0.494,31,36,0.861,16,57,73,134,43,1,47,44,183,OOR
Etdrick Bohannon,SF,25,2,4,0,0,0.0,0,0,0.0,0,0,0.0,0.0,0,0,0.0,0,0,0,0,0,0,0,0,0,OOR
Keith Booth,SF,24,39,432,49,151,0.325,1,10,0.1,48,141,0.34,0.328,21,42,0.5,25,68,93,38,22,11,39,60,120,OOR
Bruce Bowen,SF,27,30,494,26,93,0.28,7,26,0.269,19,67,0.284,0.317,11,24,0.458,15,37,52,28,21,9,13,51,70,OOR
Earl Boykins,PG,22,22,221,30,79,0.38,3,18,0.167,27,61,0.443,0.399,2,3,0.667,7,10,17,33,6,0,20,20,65,OOR
Shawn Bradley,C,26,49,1294,167,348,0.48,0,4,0.0,167,344,0.485,0.48,86,115,0.748,130,262,392,40,35,159,56,153,420,OOR
Terrell Brandon,PG,28,36,1217,212,507,0.418,12,47,0.255,200,460,0.435,0.43,65,78,0.833,27,107,134,309,63,10,74,82,501,OOR
Chucky Brown,PF,30,48,1192,176,373,0.472,15,40,0.375,161,333,0.483,0.492,40,59,0.678,36,138,174,57,16,19,38,106,407,OOR
Dee Brown,PG,30,49,1377,187,495,0.378,135,349,0.387,52,146,0.356,0.514,40,55,0.727,15,88,103,143,56,8,80,75,549,OOR
Gerald Brown,SG,23,33,236,33,89,0.371,3,10,0.3,30,79,0.38,0.388,11,14,0.786,5,17,22,31,5,1,22,21,80,OOR
P.J. Brown,PF,29,50,1611,229,477,0.48,0,0,0.0,229,477,0.48,0.48,113,146,0.774,115,231,346,66,46,48,69,166,571,OOR
Randy Brown,PG,30,39,1139,132,319,0.414,0,10,0.0,132,309,0.427,0.414,78,103,0.757,27,105,132,149,68,8,80,93,342,OOR
Rick Brunson,PG,26,17,95,6,21,0.286,0,5,0.0,6,16,0.375,0.286,5,18,0.278,3,7,10,19,9,0,12,8,17,OOR
Kobe Bryant,SG,20,50,1896,362,779,0.465,27,101,0.267,335,678,0.494,0.482,245,292,0.839,53,211,264,190,72,50,157,153,996,OOR
Mark Bryant,PF,33,45,1204,168,348,0.483,0,1,0.0,168,347,0.484,0.483,71,110,0.645,92,140,232,48,34,16,68,149,407,OOR
Jud Buechler,SF,30,50,1056,100,240,0.417,61,148,0.412,39,92,0.424,0.544,13,18,0.722,29,104,133,57,37,13,21,83,274,OOR
Matt Bullard,PF,31,41,413,43,114,0.377,24,62,0.387,19,52,0.365,0.482,7,10,0.7,9,33,42,18,13,4,14,28,117,OOR
Scott Burrell,SF,28,32,706,75,208,0.361,28,72,0.389,47,136,0.346,0.428,34,42,0.81,32,87,119,45,40,11,23,82,212,OOR
Willie Burton,SF,30,3,18,1,7,0.143,0,1,0.0,1,6,0.167,0.143,2,4,0.5,4,2,6,0,0,0,1,2,4,OOR
Mitchell Butler,SG,28,31,418,67,139,0.482,11,29,0.379,56,110,0.509,0.522,23,32,0.719,13,31,44,22,15,4,29,41,168,OOR
Jason Caffey,PF,25,35,876,123,277,0.444,0,1,0.0,123,276,0.446,0.444,62,98,0.633,79,126,205,18,24,9,75,113,308,OOR
Marcus Camby,C,24,46,945,136,261,0.521,0,0,0.0,136,261,0.521,0.521,57,103,0.553,102,151,253,12,29,74,39,131,329,OOR
Elden Campbell,C,30,49,1459,222,465,0.477,0,1,0.0,222,464,0.478,0.477,172,269,0.639,126,271,397,69,39,73,80,159,616,OOR
Antoine Carr,PF,37,18,152,21,52,0.404,0,1,0.0,21,51,0.412,0.404,5,7,0.714,9,22,31,9,1,10,9,31,47,OOR
Chris Carr,SG,24,39,445,76,205,0.371,28,75,0.373,48,130,0.369,0.439,27,40,0.675,23,48,71,23,8,2,28,45,207,OOR
Cory Carr,SG,23,42,624,71,216,0.329,5,30,0.167,66,186,0.355,0.34,24,32,0.75,8,41,49,66,21,7,46,66,171,OOR
Vince Carter,SF,22,50,1760,345,766,0.45,19,66,0.288,326,700,0.466,0.463,204,268,0.761,94,189,283,149,55,77,110,140,913,OOR
Sam Cassell,PG,29,8,199,39,93,0.419,2,10,0.2,37,83,0.446,0.43,47,50,0.94,5,10,15,36,9,0,20,22,127,OOR
Kelvin Cato,C,24,43,545,58,129,0.45,1,1,1.0,57,128,0.445,0.453,34,67,0.507,49,101,150,19,23,56,27,100,151,OOR
Duane Causwell,C,30,19,137,20,35,0.571,0,0,0.0,20,35,0.571,0.571,4,12,0.333,14,21,35,2,0,11,18,32,44,OOR
Cedric Ceballos,SF,29,13,352,59,140,0.421,11,28,0.393,48,112,0.429,0.461,34,49,0.694,23,62,85,12,7,5,28,23,163,OOR
Rex Chapman,SG,31,38,1183,165,459,0.359,53,151,0.351,112,308,0.364,0.417,76,91,0.835,12,92,104,109,34,9,54,46,459,OOR
Calbert Cheaney,SG,27,50,1266,172,415,0.414,8,37,0.216,164,378,0.434,0.424,33,67,0.493,33,108,141,73,39,16,42,146,385,OOR
Pete Chilcutt,PF,30,46,697,63,172,0.366,26,68,0.382,37,104,0.356,0.442,14,17,0.824,29,88,117,30,22,12,28,52,166,OOR
Chris Childs,PG,31,48,1297,114,267,0.427,36,94,0.383,78,173,0.451,0.494,64,78,0.821,18,115,133,193,44,1,85,156,328,OOR
Doug Christie,SG,28,50,1768,252,650,0.388,49,161,0.304,203,489,0.415,0.425,207,246,0.841,59,148,207,187,113,26,119,111,760,OOR
Keon Clark,C,23,28,409,36,80,0.45,0,1,0.0,36,79,0.456,0.45,21,37,0.568,36,60,96,10,10,31,21,52,93,OOR
Keith Closs,C,22,15,87,12,23,0.522,0,1,0.0,12,22,0.545,0.522,8,10,0.8,5,20,25,0,3,9,6,14,32,OOR
John Coker,C,27,14,98,13,31,0.419,0,0,0.0,13,31,0.419,0.419,5,6,0.833,7,15,22,0,1,2,2,17,31,OOR
Derrick Coleman,PF,31,37,1178,168,406,0.414,7,33,0.212,161,373,0.432,0.422,143,190,0.753,76,252,328,78,24,42,90,96,486,OOR
Bimbo Coles,PG,30,48,1272,183,414,0.442,6,25,0.24,177,389,0.455,0.449,83,101,0.822,21,96,117,222,45,11,82,113,455,OOR
Marty Conlon,C,31,7,35,3,13,0.231,0,0,0.0,3,13,0.231,0.231,2,2,1.0,1,4,5,1,0,1,3,6,8,OOR
Tyrone Corbin,SF,36,47,1066,131,335,0.391,38,119,0.319,93,216,0.431,0.448,52,80,0.65,37,108,145,43,31,7,43,74,352,OOR
James Cotton,SG,23,10,59,6,18,0.333,0,3,0.0,6,15,0.4,0.333,13,18,0.722,2,8,10,0,3,0,3,6,25,OOR
Chris Crawford,PF,23,42,784,110,255,0.431,11,33,0.333,99,222,0.446,0.453,57,70,0.814,37,53,90,24,10,13,48,106,288,OOR
Austin Croshere,PF,23,27,249,32,75,0.427,8,29,0.276,24,46,0.522,0.48,20,23,0.87,16,29,45,10,7,8,23,32,92,OOR
John Crotty,PG,29,27,382,51,124,0.411,14,36,0.389,37,88,0.42,0.468,43,50,0.86,8,23,31,63,11,0,33,31,159,OOR
Terry Cummings,PF,37,50,1011,186,424,0.439,1,1,1.0,185,423,0.437,0.44,81,114,0.711,95,160,255,58,46,10,58,168,454,OOR
William Cunningham,C,24,16,162,3,18,0.167,0,0,0.0,3,18,0.167,0.167,0,2,0.0,13,15,28,1,1,11,5,30,6,OOR
Bill Curley,PF,26,35,372,29,72,0.403,1,5,0.2,28,67,0.418,0.41,19,22,0.864,20,31,51,14,17,9,10,83,78,OOR
Dell Curry,SG,34,42,864,163,336,0.485,69,145,0.476,94,191,0.492,0.588,28,34,0.824,18,67,85,48,36,3,45,42,423,OOR
Michael Curry,SF,30,50,1146,90,206,0.437,1,15,0.067,89,191,0.466,0.439,63,79,0.797,19,89,108,78,42,7,37,135,244,OOR
Erick Dampier,C,23,50,1414,161,414,0.389,0,0,0.0,161,414,0.389,0.389,120,204,0.588,164,218,382,54,26,58,92,165,442,OOR
Antonio Daniels,PG,23,47,614,83,183,0.454,5,17,0.294,78,166,0.47,0.467,49,65,0.754,13,41,54,106,30,6,44,39,220,OOR
Kornél Dávid,SF,27,50,902,109,243,0.449,0,1,0.0,109,242,0.45,0.449,90,111,0.811,70,103,173,40,23,17,48,88,308,OOR
Antonio Davis,PF,30,49,1271,164,348,0.471,0,0,0.0,164,348,0.471,0.471,135,192,0.703,116,228,344,33,22,42,50,136,463,OOR
Ben Davis,PF,26,8,21,7,17,0.412,0,0,0.0,7,17,0.412,0.412,3,6,0.5,9,2,11,3,0,0,1,4,17,OOR
Dale Davis,PF,29,50,1374,161,302,0.533,0,0,0.0,161,302,0.533,0.533,76,123,0.618,155,261,416,22,20,57,43,115,398,OOR
Hubert Davis,SG,28,50,1378,174,397,0.438,65,144,0.451,109,253,0.431,0.52,44,50,0.88,3,83,86,89,21,3,57,76,457,OOR
Mark Davis,SF,25,4,35,2,6,0.333,0,0,0.0,2,6,0.333,0.333,5,6,0.833,2,5,7,1,1,0,7,12,9,OOR
Ricky Davis,SG,19,46,557,81,200,0.405,2,12,0.167,79,188,0.42,0.41,45,59,0.763,40,44,84,58,30,7,54,46,209,OOR
Terry Davis,C,31,37,578,49,92,0.533,0,0,0.0,49,92,0.533,0.533,28,38,0.737,50,89,139,10,11,3,16,79,126,OOR
Andrew DeClercq,C,25,47,1102,138,276,0.5,0,0,0.0,138,276,0.5,0.5,95,141,0.674,104,151,255,31,50,29,54,161,371,OOR
Terry Dehere,SG-PG,27,26,291,31,85,0.365,16,39,0.41,15,46,0.326,0.459,5,7,0.714,7,17,24,27,7,3,16,30,83,OOR
Vinny Del Negro,PG,32,48,1093,114,270,0.422,13,30,0.433,101,240,0.421,0.446,40,50,0.8,14,88,102,174,33,3,55,62,281,OOR
Bison Dele,C,29,49,1177,216,431,0.501,0,1,0.0,216,430,0.502,0.501,81,118,0.686,92,180,272,71,38,40,111,181,513,OOR
Tony Delk,PG,25,36,630,92,253,0.364,16,66,0.242,76,187,0.406,0.395,46,71,0.648,11,43,54,95,16,6,45,47,246,OOR
Michael Dickerson,SG,23,50,1558,215,462,0.465,71,164,0.433,144,298,0.483,0.542,46,72,0.639,26,57,83,95,27,11,66,90,547,OOR
Vlade Divac,C,30,50,1761,262,557,0.47,11,43,0.256,251,514,0.488,0.48,179,255,0.702,140,361,501,215,44,51,131,166,714,OOR
Michael Doleac,C,21,49,780,125,267,0.468,0,0,0.0,125,267,0.468,0.468,54,80,0.675,66,82,148,20,19,17,26,117,304,OOR
Sherman Douglas,PG,32,30,842,96,219,0.438,0,11,0.0,96,208,0.462,0.438,55,87,0.632,16,42,58,124,27,3,61,54,247,OOR
Bryce Drew,PG,24,34,441,47,129,0.364,16,49,0.327,31,80,0.388,0.426,8,8,1.0,3,29,32,52,12,4,31,61,118,OOR
Chris Dudley,C,33,46,685,48,109,0.44,0,0,0.0,48,109,0.44,0.44,19,40,0.475,79,114,193,7,13,38,24,116,115,OOR
Joe Dumars,SG,35,38,1116,144,350,0.411,89,221,0.403,55,129,0.426,0.539,51,61,0.836,12,56,68,134,23,2,53,51,428,OOR
Tim Duncan,PF,22,50,1963,418,845,0.495,1,7,0.143,417,838,0.498,0.495,247,358,0.69,159,412,571,121,45,126,146,147,1084,Candidate
Blue Edwards,SF,33,24,283,32,72,0.444,4,10,0.4,28,62,0.452,0.472,9,13,0.692,7,26,33,30,17,5,21,23,77,OOR
Howard Eisley,PG,26,50,1038,140,314,0.446,21,50,0.42,119,264,0.451,0.479,67,80,0.838,12,82,94,185,30,2,109,122,368,OOR
Mario Elie,SG,35,47,1291,156,331,0.471,40,107,0.374,116,224,0.518,0.532,103,119,0.866,36,101,137,89,46,12,61,91,455,OOR
Sean Elliott,SF,30,50,1509,208,507,0.41,39,119,0.328,169,388,0.436,0.449,106,140,0.757,35,178,213,117,26,17,71,104,561,OOR
Dale Ellis,SF,38,48,1232,174,395,0.441,94,217,0.433,80,178,0.449,0.559,53,70,0.757,25,90,115,38,25,3,45,77,495,OOR
LaPhonso Ellis,PF,28,20,539,80,190,0.421,1,5,0.2,79,185,0.427,0.424,43,61,0.705,25,84,109,18,8,7,34,48,204,OOR
Brian Evans,SF,25,16,145,13,44,0.295,4,13,0.308,9,31,0.29,0.341,4,4,1.0,6,13,19,15,5,3,2,8,34,OOR
Patrick Ewing,C,36,38,1300,247,568,0.435,0,2,0.0,247,566,0.436,0.435,163,231,0.706,74,303,377,43,30,100,99,105,657,OOR
Jamie Feick,PF-C,24,28,852,67,134,0.5,0,0,0.0,67,134,0.5,0.5,43,60,0.717,112,176,288,24,25,18,34,73,177,OOR
Duane Ferrell,SF,33,8,46,1,14,0.071,0,0,0.0,1,14,0.071,0.071,3,4,0.75,5,1,6,0,1,1,1,4,5,OOR
Danny Ferry,PF,32,50,1058,141,296,0.476,38,97,0.392,103,199,0.518,0.541,29,33,0.879,16,86,102,53,23,10,39,113,349,OOR
Michael Finley,SF,25,50,2051,389,876,0.444,45,136,0.331,344,740,0.465,0.47,186,226,0.823,69,194,263,218,66,15,107,96,1009,OOR
Derek Fisher,PG,24,50,1131,99,263,0.376,38,97,0.392,61,166,0.367,0.449,60,79,0.759,21,70,91,197,61,1,77,95,296,OOR
Danny Fortson,PF,22,50,1417,191,386,0.495,0,3,0.0,191,383,0.499,0.495,168,231,0.727,210,371,581,32,31,22,77,212,550,OOR
Greg Foster,PF,30,42,458,52,138,0.377,1,4,0.25,51,134,0.381,0.38,13,21,0.619,28,55,83,25,6,8,24,63,118,OOR
Rick Fox,SF,29,44,944,148,330,0.448,32,95,0.337,116,235,0.494,0.497,66,89,0.742,26,63,89,89,28,10,56,114,394,OOR
Adonal Foyle,C,23,44,614,52,121,0.43,0,0,0.0,52,121,0.43,0.43,25,51,0.49,79,115,194,18,15,43,31,90,129,OOR
Todd Fuller,C,24,42,462,56,124,0.452,0,0,0.0,56,124,0.452,0.452,30,50,0.6,28,73,101,6,6,14,27,60,142,OOR
Lawrence Funderburke,PF,28,47,936,167,299,0.559,1,5,0.2,166,294,0.565,0.56,85,120,0.708,101,121,222,30,22,23,52,77,420,OOR
Kevin Garnett,PF,22,47,1780,414,900,0.46,4,14,0.286,410,886,0.463,0.462,145,206,0.704,166,323,489,202,78,83,135,152,977,OOR
Marlon Garnett,PG,23,24,205,15,51,0.294,6,23,0.261,9,28,0.321,0.353,15,20,0.75,3,18,21,18,5,1,12,18,51,OOR
Dean Garrett,C,32,49,1054,116,231,0.502,0,0,0.0,116,231,0.502,0.502,38,51,0.745,99,158,257,28,30,45,29,113,270,OOR
Pat Garrity,PF,22,39,538,85,170,0.5,7,18,0.389,78,152,0.513,0.521,40,56,0.714,26,49,75,18,8,3,20,62,217,OOR
Chris Gatling,C,31,48,775,117,265,0.442,1,8,0.125,116,257,0.451,0.443,37,93,0.398,52,127,179,32,32,10,62,118,272,OOR
Andrew Gaze,SG,33,19,58,8,25,0.32,5,16,0.313,3,9,0.333,0.42,0,0,0.0,2,3,5,6,2,1,4,7,21,OOR
Matt Geiger,C,29,50,1540,266,555,0.479,1,5,0.2,265,550,0.482,0.48,141,177,0.797,137,225,362,58,39,40,101,157,674,OOR
Kendall Gill,SF,30,50,1606,236,593,0.398,2,17,0.118,234,576,0.406,0.4,114,167,0.683,61,183,244,123,134,26,71,162,588,OOR
Armen Gilliam,PF,34,34,668,101,223,0.453,0,1,0.0,101,222,0.455,0.453,79,101,0.782,33,93,126,19,22,12,36,48,281,OOR
Brian Grant,PF,26,48,1525,183,382,0.479,0,0,0.0,183,382,0.479,0.479,184,226,0.814,173,297,470,67,21,34,96,136,550,OOR
Gary Grant,PG,33,2,7,0,1,0.0,0,0,0.0,0,1,0.0,0.0,0,0,0.0,0,0,0,3,1,0,0,0,0,OOR
Harvey Grant,PF,33,47,798,62,168,0.369,1,6,0.167,61,162,0.377,0.372,21,29,0.724,36,74,110,23,20,16,21,73,146,OOR
Horace Grant,PF,33,50,1660,198,456,0.434,0,2,0.0,198,454,0.436,0.434,47,70,0.671,117,234,351,90,46,60,44,99,443,OOR
Paul Grant,C,25,6,13,2,6,0.333,0,0,0.0,2,6,0.333,0.333,0,0,0.0,1,0,1,0,1,0,2,4,4,OOR
Ed Gray,SG,23,30,337,53,182,0.291,12,42,0.286,41,140,0.293,0.324,28,37,0.757,7,21,28,12,12,1,29,30,146,OOR
A.C. Green,PF,35,50,924,108,256,0.422,0,8,0.0,108,248,0.435,0.422,30,52,0.577,82,146,228,25,28,8,19,69,246,OOR
Litterial Green,PG,28,1,2,0,1,0.0,0,0,0.0,0,1,0.0,0.0,0,0,0.0,0,0,0,0,0,0,0,0,0,OOR
Tom Gugliotta,PF,29,43,1563,277,573,0.483,2,7,0.286,275,566,0.486,0.485,173,218,0.794,131,250,381,121,59,21,88,110,729,OOR
Tom Hammonds,PF,31,49,716,82,179,0.458,0,0,0.0,82,179,0.458,0.458,48,75,0.64,54,82,136,20,8,7,32,88,212,OOR
Anfernee Hardaway,SG,27,50,1944,301,717,0.42,40,140,0.286,261,577,0.452,0.448,149,211,0.706,74,210,284,266,111,23,150,111,791,OOR
Tim Hardaway,PG,32,48,1772,301,752,0.4,112,311,0.36,189,441,0.429,0.475,121,149,0.812,15,137,152,352,57,6,131,102,835,OOR
Derek Harper,PG,37,45,1120,120,291,0.412,43,117,0.368,77,174,0.443,0.486,26,32,0.813,13,54,67,187,44,4,52,66,309,OOR
Ron Harper,SG,35,35,1107,147,390,0.377,27,85,0.318,120,305,0.393,0.412,71,101,0.703,49,131,180,115,60,35,65,80,392,OOR
Matt Harpring,SF,22,50,1114,148,320,0.463,10,25,0.4,138,295,0.468,0.478,102,143,0.713,88,126,214,45,30,6,73,112,408,OOR
Al Harrington,PF,18,21,160,18,56,0.321,0,5,0.0,18,51,0.353,0.321,9,15,0.6,20,19,39,5,4,2,11,26,45,OOR
Othella Harrington,PF,25,41,903,156,304,0.513,0,0,0.0,156,304,0.513,0.513,88,122,0.721,72,174,246,15,6,25,61,103,400,OOR
Lucious Harris,SG,28,36,602,73,181,0.403,11,50,0.22,62,131,0.473,0.434,36,48,0.75,21,46,67,31,18,7,18,52,193,OOR
Hersey Hawkins,SG,32,50,1644,171,408,0.419,55,180,0.306,116,228,0.509,0.487,119,132,0.902,51,150,201,123,80,18,80,90,516,OOR
Michael Hawkins,PG,26,24,203,14,40,0.35,5,19,0.263,9,21,0.429,0.413,3,3,1.0,10,15,25,27,3,1,13,14,36,OOR
Alan Henderson,SF,26,38,1142,187,423,0.442,0,1,0.0,187,422,0.443,0.442,100,149,0.671,100,150,250,28,33,19,58,96,474,OOR
Cedric Henderson,SF,23,50,1517,189,453,0.417,2,12,0.167,187,441,0.424,0.419,74,91,0.813,45,152,197,113,58,24,97,136,454,OOR
J.R. Henderson,SF,22,30,331,35,96,0.365,2,5,0.4,33,91,0.363,0.375,25,45,0.556,20,27,47,22,9,4,18,29,97,OOR
Mark Hendrickson,PF,24,22,399,39,88,0.443,0,1,0.0,39,87,0.448,0.443,42,50,0.84,27,41,68,13,12,1,15,39,120,OOR
Steve Henson,PG,30,4,25,1,2,0.5,0,0,0.0,1,2,0.5,0.5,2,2,1.0,0,0,0,3,1,0,3,1,4,OOR
Carl Herrera,PF,32,28,307,30,76,0.395,0,1,0.0,30,75,0.4,0.395,5,11,0.455,25,37,62,4,12,7,16,41,65,OOR
Grant Hill,SF,26,50,1852,384,802,0.479,0,14,0.0,384,788,0.487,0.479,285,379,0.752,65,290,355,300,80,27,184,114,1053,OOR
Tyrone Hill,PF,30,38,1104,122,268,0.455,0,0,0.0,122,268,0.455,0.455,81,150,0.54,115,172,287,35,34,16,59,145,325,OOR
Fred Hoiberg,SG,26,12,87,6,21,0.286,1,9,0.111,5,12,0.417,0.31,6,6,1.0,2,9,11,4,0,0,3,11,19,OOR
Jerald Honeycutt,PF,24,16,102,9,32,0.281,5,17,0.294,4,15,0.267,0.359,7,10,0.7,3,9,12,3,5,2,9,16,30,OOR
Jeff Hornacek,SG,35,48,1435,214,449,0.477,34,81,0.42,180,368,0.489,0.514,125,140,0.893,33,127,160,192,52,14,82,95,587,OOR
Robert Horry,PF,28,38,744,67,146,0.459,20,45,0.444,47,101,0.465,0.527,34,46,0.739,56,96,152,56,36,39,49,103,188,OOR
Allan Houston,SG,27,50,1815,294,703,0.418,57,140,0.407,237,563,0.421,0.459,168,195,0.862,20,132,152,137,35,9,130,115,813,OOR
Juwan Howard,SF,25,36,1430,286,604,0.474,0,3,0.0,286,601,0.476,0.474,110,146,0.753,90,203,293,107,42,14,95,130,682,OOR
Troy Hudson,PG,22,25,524,60,150,0.4,15,47,0.319,45,103,0.437,0.45,34,38,0.895,15,40,55,92,11,2,38,28,169,OOR
Larry Hughes,PG,20,50,988,170,414,0.411,8,52,0.154,162,362,0.448,0.42,107,151,0.709,83,106,189,77,44,14,68,97,455,OOR
Lindsey Hunter,PG,28,49,1755,228,524,0.435,59,153,0.386,169,371,0.456,0.491,67,89,0.753,26,142,168,193,86,8,92,126,582,OOR
Zydrunas Ilgauskas,C,23,5,171,29,57,0.509,0,0,0.0,29,57,0.509,0.509,18,30,0.6,17,27,44,4,4,7,9,24,76,OOR
Allen Iverson,SG,23,48,1990,435,1056,0.412,58,199,0.291,377,857,0.44,0.439,356,474,0.751,66,170,236,223,110,7,167,98,1284,Candidate
Bobby Jackson,PG,25,50,941,141,348,0.405,10,27,0.37,131,321,0.408,0.42,61,79,0.772,43,92,135,167,39,3,75,75,353,OOR
Jaren Jackson,SG,31,47,861,108,284,0.38,53,147,0.361,55,137,0.401,0.474,32,39,0.821,21,78,99,49,41,9,37,63,301,OOR
Jim Jackson,SG,28,49,1175,152,370,0.411,25,90,0.278,127,280,0.454,0.445,85,101,0.842,36,123,159,128,43,6,82,80,414,OOR
Mark Jackson,PG,33,49,1382,138,329,0.419,32,103,0.311,106,226,0.469,0.468,65,79,0.823,33,151,184,386,42,3,99,58,373,OOR
Randell Jackson,PF,23,27,271,46,108,0.426,1,7,0.143,45,101,0.446,0.431,21,32,0.656,30,24,54,8,3,11,26,29,114,OOR
Sam Jacobson,PG,23,2,12,3,5,0.6,0,1,0.0,3,4,0.75,0.6,2,2,1.0,0,3,3,0,0,0,1,2,8,OOR
Jerome James,C,23,16,42,9,24,0.375,0,0,0.0,9,24,0.375,0.375,6,12,0.5,6,11,17,1,2,6,9,11,24,OOR
Antawn Jamison,SF,22,47,1058,178,394,0.452,3,10,0.3,175,384,0.456,0.456,90,153,0.588,131,170,301,34,38,16,68,102,449,OOR
Anthony Johnson,PG,24,49,885,91,225,0.404,5,19,0.263,86,206,0.417,0.416,57,82,0.695,16,59,75,107,35,7,65,67,244,OOR
Avery Johnson,PG,33,50,1672,218,461,0.473,1,12,0.083,217,449,0.483,0.474,50,88,0.568,22,96,118,369,51,11,112,101,487,OOR
Eddie Johnson,SF,39,3,18,6,13,0.462,0,1,0.0,6,12,0.5,0.462,0,0,0.0,0,2,2,1,0,0,2,3,12,OOR
Ervin Johnson,C,31,50,1027,96,189,0.508,0,0,0.0,96,189,0.508,0.508,64,105,0.61,120,200,320,19,29,57,47,151,256,OOR
Larry Johnson,PF,29,49,1639,210,458,0.459,33,92,0.359,177,366,0.484,0.495,134,164,0.817,91,193,284,119,34,10,89,147,587,OOR
Charles Jones,SG,23,29,476,39,123,0.317,19,61,0.311,20,62,0.323,0.394,11,22,0.5,9,33,42,41,18,5,29,30,108,OOR
Damon Jones,PG,22,24,344,43,119,0.361,25,62,0.403,18,57,0.316,0.466,14,17,0.824,6,38,44,42,13,0,17,23,125,OOR
Eddie Jones,SF-SG,27,50,1881,260,595,0.437,48,142,0.338,212,453,0.468,0.477,212,271,0.782,50,144,194,186,125,58,93,128,780,OOR
Popeye Jones,PF,28,18,206,20,51,0.392,0,1,0.0,20,50,0.4,0.392,14,17,0.824,28,24,52,15,5,0,7,31,54,OOR
Adonis Jordan,PG,28,4,18,2,4,0.5,0,2,0.0,2,2,1.0,0.5,2,4,0.5,0,0,0,3,3,0,2,0,6,OOR
Reggie Jordan,SG,31,27,296,15,54,0.278,0,0,0.0,15,54,0.278,0.278,21,38,0.553,27,32,59,41,12,5,14,38,51,OOR
Adam Keefe,PF,28,44,642,56,124,0.452,0,4,0.0,56,120,0.467,0.452,62,89,0.697,51,91,142,28,16,12,33,63,174,OOR
Shawn Kemp,PF,29,42,1475,277,575,0.482,1,2,0.5,276,573,0.482,0.483,307,389,0.789,131,257,388,101,48,45,127,159,862,OOR
Jonathan Kerner,C,24,1,5,0,1,0.0,0,0,0.0,0,1,0.0,0.0,0,0,0.0,0,0,0,0,0,0,0,2,0,OOR
Steve Kerr,PG,33,44,734,68,174,0.391,25,80,0.313,43,94,0.457,0.463,31,35,0.886,6,38,44,49,23,3,22,28,192,OOR
Jerome Kersey,SF,36,45,699,68,200,0.34,3,14,0.214,65,186,0.349,0.348,6,14,0.429,42,88,130,41,37,14,30,92,145,OOR
Jason Kidd,PG,25,50,2060,310,698,0.444,45,123,0.366,265,575,0.461,0.476,181,239,0.757,87,252,339,539,114,19,150,108,846,Candidate
Chris King,SF,29,8,42,2,7,0.286,0,0,0.0,2,7,0.286,0.286,0,4,0.0,1,10,11,1,2,1,4,8,4,OOR
Gerard King,SF,26,19,63,6,14,0.429,0,0,0.0,6,14,0.429,0.429,11,18,0.611,6,8,14,4,2,1,4,12,23,OOR
Kerry Kittles,SG,24,46,1570,227,613,0.37,50,158,0.316,177,455,0.389,0.411,88,114,0.772,52,139,191,116,79,26,66,82,592,OOR
Joe Kleine,C,37,31,374,30,74,0.405,0,2,0.0,30,72,0.417,0.405,8,12,0.667,27,40,67,12,8,1,10,46,68,OOR
Brevin Knight,PG,23,39,1186,134,315,0.425,0,5,0.0,134,310,0.432,0.425,105,141,0.745,16,115,131,302,70,7,105,115,373,OOR
Negele Knight,PG,31,6,56,3,8,0.375,0,1,0.0,3,7,0.429,0.375,2,4,0.5,1,5,6,8,1,0,7,5,8,OOR
Travis Knight,C,24,37,525,67,130,0.515,0,1,0.0,67,129,0.519,0.515,22,29,0.759,34,94,128,31,21,27,35,108,156,OOR
Toni Kukoč,SF,30,44,1654,315,750,0.42,39,137,0.285,276,613,0.45,0.446,159,215,0.74,65,245,310,235,49,11,121,82,828,OOR
Christian Laettner,PF,29,16,337,38,106,0.358,1,3,0.333,37,103,0.359,0.363,44,57,0.772,21,33,54,24,15,12,19,30,121,OOR
Raef LaFrentz,C,22,12,387,59,129,0.457,12,31,0.387,47,98,0.48,0.504,36,48,0.75,33,58,91,8,9,17,9,38,166,OOR
Andrew Lang,C,32,21,386,32,99,0.323,0,0,0.0,32,99,0.323,0.323,16,23,0.696,33,60,93,13,5,12,17,43,80,OOR
Antonio Lang,PF,26,10,65,4,6,0.667,0,0,0.0,4,6,0.667,0.667,5,9,0.556,6,10,16,1,2,1,4,13,13,OOR
Rusty LaRue,PG,25,43,732,78,217,0.359,30,89,0.337,48,128,0.375,0.429,17,17,1.0,9,47,56,63,33,3,34,66,203,OOR
Tim Legler,SG,32,30,377,51,115,0.443,14,35,0.4,37,80,0.463,0.504,3,6,0.5,8,32,40,21,4,3,14,42,119,OOR
Voshon Lenard,SG,25,12,190,31,79,0.392,12,35,0.343,19,44,0.432,0.468,8,11,0.727,4,12,16,10,3,1,7,18,82,OOR
Rashard Lewis,SF,19,20,145,19,52,0.365,1,6,0.167,18,46,0.391,0.375,8,14,0.571,13,12,25,4,8,1,20,19,47,OOR
Randy Livingston,PG,23,1,22,5,8,0.625,0,0,0.0,5,8,0.625,0.625,2,2,1.0,0,2,2,3,2,0,1,1,12,OOR
Grant Long,PF,32,50,1380,151,359,0.421,3,18,0.167,148,341,0.434,0.425,184,235,0.783,100,196,296,53,57,16,74,143,489,OOR
Luc Longley,C,30,39,933,140,290,0.483,0,0,0.0,140,290,0.483,0.483,59,76,0.776,59,162,221,45,23,21,53,119,339,OOR
Felipe López,SG,24,47,1218,169,379,0.446,12,44,0.273,157,335,0.469,0.462,87,135,0.644,69,97,166,62,49,14,82,128,437,OOR
Tyronn Lue,PG,21,15,188,28,65,0.431,7,16,0.438,21,49,0.429,0.485,12,21,0.571,2,4,6,25,5,0,11,28,75,OOR
George Lynch,SF,28,43,1315,147,349,0.421,9,23,0.391,138,326,0.423,0.434,53,84,0.631,110,169,279,76,85,22,79,142,356,OOR
Sam Mack,SF,28,44,1083,167,384,0.435,87,219,0.397,80,165,0.485,0.548,51,58,0.879,14,81,95,55,35,4,33,94,472,OOR
Don MacLean,PF,29,17,365,63,159,0.396,9,33,0.273,54,126,0.429,0.425,50,80,0.625,18,47,65,16,5,5,25,34,185,OOR
Mark Macon,SG,29,7,69,4,20,0.2,1,3,0.333,3,17,0.176,0.225,0,0,0.0,3,2,5,4,5,1,6,6,9,OOR
Rick Mahorn,PF,40,16,127,5,18,0.278,0,0,0.0,5,18,0.278,0.278,3,8,0.375,7,16,23,2,5,1,6,22,13,OOR
Dan Majerle,SG,33,48,1624,118,298,0.396,68,203,0.335,50,95,0.526,0.51,33,46,0.717,21,187,208,150,38,7,55,100,337,OOR
Karl Malone,PF,35,49,1832,393,797,0.493,0,1,0.0,393,796,0.494,0.493,378,480,0.788,107,356,463,201,62,28,162,134,1164,MVP
Matt Maloney,PG,27,15,186,5,28,0.179,1,15,0.067,4,13,0.308,0.196,10,11,0.909,2,8,10,21,4,0,14,7,21,OOR
Danny Manning,PF,32,50,1184,187,386,0.484,1,9,0.111,186,377,0.493,0.486,78,112,0.696,62,157,219,113,36,38,69,129,453,OOR
Stephon Marbury,PG,21,49,1895,378,883,0.428,66,197,0.335,312,686,0.455,0.465,222,278,0.799,37,105,142,437,59,8,164,125,1044,OOR
Sean Marks,PF,23,8,28,5,8,0.625,0,0,0.0,5,8,0.625,0.625,1,2,0.5,0,1,1,0,1,0,3,3,11,OOR
Donyell Marshall,SF,25,48,1250,208,494,0.421,26,72,0.361,182,422,0.431,0.447,88,121,0.727,115,227,342,66,47,37,80,123,530,OOR
Darrick Martin,PG,27,37,941,102,278,0.367,31,106,0.292,71,172,0.413,0.423,61,76,0.803,5,43,48,144,43,4,67,82,296,OOR
Jamal Mashburn,SF,26,24,855,134,297,0.451,13,30,0.433,121,267,0.453,0.473,75,104,0.721,24,122,146,75,20,3,60,58,356,OOR
Tony Massenburg,PF,31,43,1143,189,388,0.487,0,2,0.0,189,386,0.49,0.487,103,155,0.665,83,174,257,23,26,39,64,108,481,OOR
Vernon Maxwell,SG,33,46,1007,164,421,0.39,80,231,0.346,84,190,0.442,0.485,84,114,0.737,13,72,85,76,30,3,67,111,492,OOR
Lee Mayberry,PG,28,9,126,7,19,0.368,2,10,0.2,5,9,0.556,0.421,4,5,0.8,0,3,3,23,7,0,11,13,20,OOR
Kelly McCarty,SG,23,2,4,2,3,0.667,0,0,0.0,2,3,0.667,0.667,0,0,0.0,2,1,3,0,0,0,2,0,4,OOR
Walter McCarty,PF,24,32,659,64,177,0.362,13,50,0.26,51,127,0.402,0.398,40,57,0.702,36,79,115,40,24,13,40,88,181,OOR
George McCloud,SF,31,48,1245,142,324,0.438,69,166,0.416,73,158,0.462,0.545,75,87,0.862,34,128,162,79,45,14,49,128,428,OOR
Jelani McCoy,C,21,26,331,56,76,0.737,0,0,0.0,56,76,0.737,0.737,21,42,0.5,27,52,79,4,11,20,10,42,133,OOR
Antonio McDyess,C,24,50,1937,415,882,0.471,1,9,0.111,414,873,0.474,0.471,230,338,0.68,168,369,537,82,73,115,138,175,1061,OOR
Tracy McGrady,SF,19,49,1106,168,385,0.436,8,35,0.229,160,350,0.457,0.447,114,157,0.726,120,158,278,113,52,66,80,94,458,OOR
Jim McIlvaine,C,26,22,269,22,51,0.431,0,0,0.0,22,51,0.431,0.431,4,6,0.667,31,23,54,2,9,32,13,59,48,OOR
Jeff McInnis,PG,24,35,427,50,134,0.373,9,35,0.257,41,99,0.414,0.407,21,28,0.75,9,12,21,73,19,1,30,36,130,OOR
Derrick McKey,SF,32,13,244,23,52,0.442,0,1,0.0,23,51,0.451,0.442,14,17,0.824,18,23,41,13,12,4,12,24,60,OOR
Aaron McKie,SG,26,50,959,95,237,0.401,6,31,0.194,89,206,0.432,0.414,44,62,0.71,27,113,140,100,63,3,57,90,240,OOR
Roshown McLeod,SF,23,34,348,62,163,0.38,1,10,0.1,61,153,0.399,0.383,37,45,0.822,12,38,50,14,2,1,23,24,162,OOR
Ron Mercer,SG,22,41,1551,305,707,0.431,5,30,0.167,300,677,0.443,0.435,83,105,0.79,37,118,155,104,67,12,89,81,698,OOR
Loren Meyer,C,26,14,70,7,28,0.25,1,5,0.2,6,23,0.261,0.268,1,2,0.5,4,12,16,1,0,3,4,22,16,OOR
Marko Milič,SG,21,11,53,8,20,0.4,0,1,0.0,8,19,0.421,0.4,0,0,0.0,3,2,5,2,3,1,6,7,16,OOR
Anthony Miller,PF,27,29,249,28,60,0.467,0,1,0.0,28,59,0.475,0.467,14,22,0.636,26,41,67,7,7,5,9,34,70,OOR
Brad Miller,C,22,38,469,78,138,0.565,1,2,0.5,77,136,0.566,0.569,81,102,0.794,35,82,117,22,9,18,32,65,238,OOR
Oliver Miller,C,28,4,35,5,11,0.455,0,0,0.0,5,11,0.455,0.455,0,0,0.0,7,1,8,0,0,2,4,3,10,OOR
Reggie Miller,SG,33,50,1787,294,671,0.438,106,275,0.385,188,396,0.475,0.517,226,247,0.915,25,110,135,112,37,9,76,101,920,OOR
Chris Mills,SF,29,47,1395,186,453,0.411,32,115,0.278,154,338,0.456,0.446,79,96,0.823,49,188,237,103,39,14,58,125,483,OOR
Terry Mills,PF,31,1,29,3,8,0.375,2,4,0.5,1,4,0.25,0.5,1,2,0.5,3,1,4,0,1,0,3,3,9,OOR
Greg Minor,SG,27,44,765,85,204,0.417,8,28,0.286,77,176,0.438,0.436,36,48,0.75,31,86,117,50,20,6,38,69,214,OOR
Sam Mitchell,SF,35,50,1344,213,522,0.408,9,38,0.237,204,484,0.421,0.417,126,165,0.764,55,127,182,98,35,16,34,111,561,OOR
Cuttino Mobley,PG,23,49,1456,172,405,0.425,53,148,0.358,119,257,0.463,0.49,90,110,0.818,22,89,111,121,44,23,79,98,487,OOR
Nazr Mohammed,C,21,26,121,15,42,0.357,0,0,0.0,15,42,0.357,0.357,12,21,0.571,18,19,37,2,5,4,12,22,42,OOR
Eric Montross,C,27,46,577,42,80,0.525,0,1,0.0,42,79,0.532,0.525,11,32,0.344,45,94,139,14,12,27,16,107,95,OOR
Mikki Moore,C,23,2,6,1,1,1.0,0,0,0.0,1,1,1.0,1.0,2,2,1.0,0,1,1,0,0,0,0,0,4,OOR
Chris Morris,SF,33,44,535,64,149,0.43,16,56,0.286,48,93,0.516,0.483,40,46,0.87,54,67,121,23,16,11,21,54,184,OOR
Alonzo Mourning,C,28,46,1753,324,634,0.511,0,2,0.0,324,632,0.513,0.511,276,423,0.652,166,341,507,74,34,180,139,161,924,Candidate
Chris Mullin,SF,35,50,1179,177,371,0.477,73,157,0.465,104,214,0.486,0.575,80,92,0.87,25,135,160,81,47,13,60,101,507,OOR
Eric Murdock,PG,30,15,401,45,114,0.395,8,22,0.364,37,92,0.402,0.43,21,26,0.808,3,32,35,66,22,2,29,35,119,OOR
Gheorghe Mureșan,C,27,1,1,0,1,0.0,0,0,0.0,0,1,0.0,0.0,0,0,0.0,0,0,0,0,0,0,1,0,0,OOR
Lamond Murray,SF,25,50,1317,226,578,0.391,34,103,0.33,192,475,0.404,0.42,126,157,0.803,59,136,195,61,58,20,99,107,612,OOR
Tracy Murray,SF,27,36,653,83,237,0.35,33,103,0.32,50,134,0.373,0.42,34,42,0.81,18,63,81,27,21,6,29,65,233,OOR
Dikembe Mutombo,C,32,50,1829,173,338,0.512,0,0,0.0,173,338,0.512,0.512,195,285,0.684,192,418,610,57,16,147,94,145,541,OOR
Makhtar N'Diaye,PF,25,4,27,1,4,0.25,0,0,0.0,1,4,0.25,0.25,3,4,0.75,3,2,5,1,0,1,1,9,5,OOR
Steve Nash,PG,24,40,1269,114,314,0.363,49,131,0.374,65,183,0.355,0.441,38,46,0.826,32,82,114,219,37,2,83,98,315,OOR
Tyrone Nesby,SF,23,50,1288,182,405,0.449,35,96,0.365,147,309,0.476,0.493,104,133,0.782,57,118,175,82,77,20,53,143,503,OOR
Rasho Nesterović,C,22,2,30,3,12,0.25,0,0,0.0,3,12,0.25,0.25,2,2,1.0,3,5,8,1,0,0,1,5,8,OOR
Johnny Newman,SF,35,50,949,106,251,0.422,23,61,0.377,83,190,0.437,0.468,68,84,0.81,15,60,75,41,28,12,41,126,303,OOR
Moochie Norris,PG,25,12,140,13,40,0.325,6,15,0.4,7,25,0.28,0.4,6,16,0.375,4,16,20,24,7,0,16,17,38,OOR
Dirk Nowitzki,PF,20,47,958,136,336,0.405,14,68,0.206,122,268,0.455,0.426,99,128,0.773,41,121,162,47,29,27,73,105,385,OOR
Charles O'Bannon,SG,23,18,165,24,56,0.429,0,1,0.0,24,55,0.436,0.429,8,8,1.0,18,16,34,12,2,3,8,22,56,OOR
Jermaine O'Neal,PF,20,36,311,36,83,0.434,0,1,0.0,36,82,0.439,0.434,18,35,0.514,42,55,97,13,4,14,14,41,90,OOR
Shaquille O'Neal,C,26,49,1705,510,885,0.576,0,1,0.0,510,884,0.577,0.576,269,498,0.54,187,338,525,114,36,82,122,155,1289,OOR
Charles Oakley,PF,35,50,1633,140,327,0.428,1,5,0.2,139,322,0.432,0.43,67,83,0.807,96,278,374,168,46,21,96,182,348,OOR
Hakeem Olajuwon,C,36,50,1784,373,725,0.514,4,13,0.308,369,712,0.518,0.517,195,272,0.717,106,372,478,88,82,123,139,160,945,OOR
Jimmy Oliver,SG,29,2,11,1,3,0.333,1,1,1.0,0,2,0.0,0.5,0,0,0.0,0,0,0,0,0,0,0,2,3,OOR
Kevin Ollie,PG,26,8,72,4,14,0.286,0,0,0.0,4,14,0.286,0.286,5,7,0.714,0,7,7,3,3,1,3,9,13,OOR
Michael Olowokandi,C,23,45,1279,172,399,0.431,0,0,0.0,172,399,0.431,0.431,57,118,0.483,120,237,357,25,27,55,85,137,401,OOR
Greg Ostertag,C,25,48,1340,99,208,0.476,0,0,0.0,99,208,0.476,0.476,75,121,0.62,105,243,348,23,12,131,45,140,273,OOR
Bo Outlaw,PF,27,31,851,84,154,0.545,0,3,0.0,84,151,0.556,0.545,35,81,0.432,54,113,167,56,40,43,58,79,203,OOR
Doug Overton,PG,29,24,244,36,84,0.429,2,7,0.286,34,77,0.442,0.44,18,20,0.9,7,14,21,23,5,1,20,18,92,OOR
Billy Owens,SF,29,21,451,65,165,0.394,5,11,0.455,60,154,0.39,0.409,28,35,0.8,35,45,80,38,12,4,33,37,163,OOR
Robert Pack,PG,29,25,468,75,174,0.431,0,4,0.0,75,170,0.441,0.431,72,88,0.818,9,27,36,81,20,1,49,41,222,OOR
Anthony Parker,SG,23,2,3,1,1,1.0,0,0,0.0,1,1,1.0,1.0,0,0,0.0,0,0,0,0,0,0,0,0,2,OOR
Cherokee Parks,C,26,48,1118,118,275,0.429,0,1,0.0,118,274,0.431,0.429,30,55,0.545,75,168,243,36,28,28,49,114,266,OOR
Andrae Patterson,PF,23,35,284,43,97,0.443,0,5,0.0,43,92,0.467,0.443,28,36,0.778,30,35,65,15,19,7,22,62,114,OOR
Ruben Patterson,SF,23,24,144,21,51,0.412,1,6,0.167,20,45,0.444,0.422,22,31,0.71,17,13,30,2,5,3,12,16,65,OOR
Gary Payton,PG,30,50,2008,401,923,0.434,83,281,0.295,318,642,0.495,0.479,199,276,0.721,62,182,244,436,109,12,154,115,1084,OOR
Anthony Peeler,SG,29,28,810,103,272,0.379,34,114,0.298,69,158,0.437,0.441,30,41,0.732,30,54,84,78,35,6,38,60,270,OOR
Will Perdue,C,33,37,445,38,60,0.633,0,0,0.0,38,60,0.633,0.633,14,26,0.538,33,105,138,18,9,10,22,63,90,OOR
Sam Perkins,PF,37,48,789,80,200,0.4,35,90,0.389,45,110,0.409,0.488,43,60,0.717,36,102,138,25,15,14,22,74,238,OOR
Elliot Perry,PG,29,35,290,39,103,0.379,10,24,0.417,29,79,0.367,0.427,10,14,0.714,7,27,34,47,20,0,34,25,98,OOR
Chuck Person,SF,34,50,990,112,289,0.388,55,157,0.35,57,132,0.432,0.483,24,32,0.75,17,115,132,60,20,8,41,90,303,OOR
Wesley Person,SG,27,45,1342,198,437,0.453,75,200,0.375,123,237,0.519,0.539,32,53,0.604,19,123,142,80,37,16,41,52,503,OOR
Bobby Phills,SG,29,43,1574,215,497,0.433,68,172,0.395,147,325,0.452,0.501,115,168,0.685,39,135,174,149,60,25,92,124,613,OOR
Eric Piatkowski,SG,28,49,1242,180,417,0.432,65,165,0.394,115,252,0.456,0.51,88,102,0.863,39,101,140,53,44,6,53,86,513,OOR
Paul Pierce,SF,21,48,1632,284,647,0.439,84,204,0.412,200,443,0.451,0.504,139,195,0.713,117,192,309,115,82,50,113,139,791,OOR
Scottie Pippen,SF,33,50,2011,261,604,0.432,72,212,0.34,189,392,0.482,0.492,132,183,0.721,63,260,323,293,98,37,159,118,726,OOR
Scot Pollard,C,23,16,259,33,61,0.541,0,0,0.0,33,61,0.541,0.541,16,23,0.696,38,44,82,4,8,18,5,41,82,OOR
Olden Polynice,C,34,48,1481,169,358,0.472,1,1,1.0,168,357,0.471,0.473,29,94,0.309,184,241,425,43,20,30,49,150,368,OOR
Mark Pope,SF,26,4,26,1,7,0.143,0,4,0.0,1,3,0.333,0.143,0,1,0.0,2,2,4,0,0,0,1,6,2,OOR
Terry Porter,PG,35,50,1365,172,370,0.465,58,141,0.411,114,229,0.498,0.543,123,148,0.831,13,127,140,146,48,11,74,97,525,OOR
Vitaly Potapenko,C,23,50,1394,204,412,0.495,0,1,0.0,204,411,0.496,0.495,91,155,0.587,114,218,332,75,35,36,100,169,499,OOR
Brent Price,PG,30,40,806,100,207,0.483,46,112,0.411,54,95,0.568,0.594,46,61,0.754,18,60,78,113,33,1,65,90,292,OOR
Theo Ratliff,PF,25,50,1627,197,419,0.47,0,0,0.0,197,419,0.47,0.47,166,229,0.725,139,268,407,30,45,149,92,180,560,OOR
Eldridge Recasner,PG,31,44,708,82,184,0.446,24,60,0.4,58,124,0.468,0.511,34,39,0.872,20,57,77,91,17,1,58,66,222,OOR
Bryant Reeves,C,25,25,702,102,251,0.406,0,1,0.0,102,250,0.408,0.406,67,116,0.578,50,88,138,37,13,8,47,103,271,OOR
Khalid Reeves,PG,26,11,112,8,21,0.381,1,3,0.333,7,18,0.389,0.405,8,14,0.571,3,4,7,11,4,0,7,13,25,OOR
Don Reid,PF,25,47,935,97,174,0.557,0,0,0.0,97,174,0.557,0.557,48,79,0.608,66,104,170,33,27,43,36,156,242,OOR
J.R. Reid,PF,30,41,1029,132,277,0.477,0,1,0.0,132,276,0.478,0.477,105,137,0.766,45,167,212,48,37,10,51,135,369,OOR
Shawn Respert,SG,26,12,99,13,36,0.361,4,13,0.308,9,23,0.391,0.417,7,10,0.7,2,11,13,8,5,0,5,10,37,OOR
Rodrick Rhodes,SG-SF,25,13,156,13,52,0.25,1,7,0.143,12,45,0.267,0.26,16,25,0.64,9,8,17,11,5,2,20,21,43,OOR
Glen Rice,SF,31,27,985,171,396,0.432,53,135,0.393,118,261,0.452,0.499,77,90,0.856,9,90,99,71,17,6,45,67,472,OOR
Pooh Richardson,PG,32,11,130,12,36,0.333,0,6,0.0,12,30,0.4,0.333,4,4,1.0,1,12,13,30,4,0,9,5,28,OOR
Mitch Richmond,SG,33,50,1912,331,803,0.412,70,221,0.317,261,582,0.448,0.456,251,293,0.857,30,142,172,122,64,10,136,121,983,OOR
Isaiah Rider,SG,27,47,1385,249,605,0.412,42,111,0.378,207,494,0.419,0.446,111,147,0.755,59,137,196,104,25,9,95,100,651,OOR
Eric Riley,C,28,35,337,28,54,0.519,0,0,0.0,28,54,0.519,0.519,22,31,0.71,36,63,99,13,9,26,26,73,78,OOR
Stanley Roberts,C,28,6,33,5,13,0.385,0,0,0.0,5,13,0.385,0.385,4,8,0.5,4,7,11,0,0,1,4,2,14,OOR
Clifford Robinson,SF,32,50,1740,299,629,0.475,58,139,0.417,241,490,0.492,0.521,163,234,0.697,69,158,227,128,75,59,88,153,819,OOR
David Robinson,C,33,49,1554,268,527,0.509,0,1,0.0,268,526,0.51,0.509,239,363,0.658,148,344,492,103,69,119,108,143,775,OOR
Glenn Robinson,SF,26,47,1579,347,756,0.459,31,79,0.392,316,677,0.467,0.479,140,161,0.87,73,203,276,100,46,41,106,114,865,OOR
James Robinson,PG,28,31,506,67,185,0.362,21,74,0.284,46,111,0.414,0.419,28,41,0.683,18,44,62,56,22,8,44,60,183,OOR
Dennis Rodman,PF,37,23,657,16,46,0.348,0,2,0.0,16,44,0.364,0.348,17,39,0.436,62,196,258,30,10,12,31,71,49,OOR
Carlos Rogers,PF,27,2,8,2,2,1.0,0,0,0.0,2,2,1.0,1.0,1,4,0.25,0,1,1,1,0,0,0,2,5,OOR
Rodney Rogers,SF,27,47,968,131,297,0.441,18,63,0.286,113,234,0.483,0.471,68,101,0.673,65,114,179,77,47,22,66,140,348,OOR
Sean Rooks,C,29,36,315,32,79,0.405,0,2,0.0,32,77,0.416,0.405,34,48,0.708,33,39,72,9,2,9,21,61,98,OOR
Jalen Rose,SF,26,49,1238,200,496,0.403,17,65,0.262,183,431,0.425,0.42,125,158,0.791,34,120,154,93,50,15,72,128,542,OOR
Malik Rose,PF,24,47,608,93,201,0.463,0,1,0.0,93,200,0.465,0.463,98,146,0.671,90,92,182,29,40,22,56,120,284,OOR
Bryon Russell,SF,28,50,1770,217,468,0.464,52,147,0.354,165,321,0.514,0.519,136,171,0.795,65,201,266,74,76,15,76,154,622,OOR
Arvydas Sabonis,C,34,50,1349,232,478,0.485,7,24,0.292,225,454,0.496,0.493,135,175,0.771,88,305,393,119,34,63,85,147,606,OOR
Jason Sasser,SF,25,6,39,5,11,0.455,0,0,0.0,5,11,0.455,0.455,1,2,0.5,2,5,7,2,2,0,2,4,11,OOR
Danny Schayes,C,39,19,143,11,29,0.379,0,0,0.0,11,29,0.379,0.379,6,8,0.75,3,11,14,4,1,2,8,23,28,OOR
Dwayne Schintzius,C,30,16,67,4,16,0.25,0,0,0.0,4,16,0.25,0.25,3,4,0.75,7,12,19,8,0,3,10,17,11,OOR
Detlef Schrempf,SF,36,50,1765,259,549,0.472,34,86,0.395,225,463,0.486,0.503,200,243,0.823,77,293,370,184,41,26,103,152,752,OOR
Dennis Scott,SF,30,36,738,87,213,0.408,37,97,0.381,50,116,0.431,0.495,23,31,0.742,8,50,58,40,15,3,19,49,234,OOR
Malik Sealy,SF,28,31,731,95,231,0.411,6,23,0.261,89,208,0.428,0.424,55,61,0.902,23,69,92,36,30,5,33,68,251,OOR
Rony Seikaly,C,33,9,88,4,20,0.2,0,0,0.0,4,20,0.2,0.2,7,18,0.389,5,16,21,2,4,6,10,15,15,OOR
Charles Shackleford,C,32,32,367,44,90,0.489,0,0,0.0,44,90,0.489,0.489,19,29,0.655,41,88,129,13,5,13,27,66,107,OOR
Brian Shaw,PG,32,1,5,0,1,0.0,0,0,0.0,0,1,0.0,0.0,0,0,0.0,0,1,1,1,0,0,1,1,0,OOR
Casey Shaw,C,23,9,14,1,8,0.125,0,0,0.0,1,8,0.125,0.125,0,0,0.0,3,0,3,0,0,0,2,2,2,OOR
Jeff Sheppard,SG,24,18,185,15,39,0.385,2,7,0.286,13,32,0.406,0.41,8,13,0.615,6,16,22,16,3,0,7,12,40,OOR
Miles Simon,SG,23,5,19,1,5,0.2,0,2,0.0,1,3,0.333,0.2,0,0,0.0,1,1,2,0,1,0,3,1,2,OOR
Dickey Simpkins,C,26,50,1448,150,324,0.463,0,1,0.0,150,323,0.464,0.463,156,242,0.645,110,229,339,65,36,13,72,128,456,OOR
Alvin Sims,SG,24,4,25,4,10,0.4,1,1,1.0,3,9,0.333,0.45,2,5,0.4,3,1,4,5,2,0,6,2,11,OOR
Brian Skinner,PF,22,21,258,33,71,0.465,0,0,0.0,33,71,0.465,0.465,20,33,0.606,20,33,53,1,10,13,19,20,86,OOR
Reggie Slater,PF,28,30,263,31,81,0.383,0,0,0.0,31,81,0.383,0.383,53,85,0.624,36,34,70,5,3,3,25,50,115,OOR
Charles Smith,SG,23,23,317,35,97,0.361,7,33,0.212,28,64,0.438,0.397,7,16,0.438,7,17,24,13,17,14,20,35,84,OOR
Joe Smith,C,23,43,1418,223,522,0.427,0,3,0.0,223,519,0.43,0.427,142,188,0.755,154,200,354,68,32,66,66,147,588,OOR
Michael Smith,PF,26,48,1098,77,144,0.535,0,1,0.0,77,143,0.538,0.535,76,128,0.594,135,215,350,48,46,18,60,107,230,OOR
Steve Smith,SG,29,36,1314,217,540,0.402,47,139,0.338,170,401,0.424,0.445,191,225,0.849,50,101,151,118,36,11,99,100,672,OOR
Rik Smits,C,32,49,1271,310,633,0.49,0,2,0.0,310,631,0.491,0.49,108,132,0.818,73,202,275,52,18,52,75,159,728,OOR
Eric Snow,PG,25,48,1716,149,348,0.428,5,21,0.238,144,327,0.44,0.435,110,150,0.733,25,137,162,301,100,1,111,149,413,OOR
Felton Spencer,C,31,26,159,15,33,0.455,0,0,0.0,15,33,0.455,0.455,12,26,0.462,18,28,46,0,5,10,9,41,42,OOR
Latrell Sprewell,SF,28,37,1233,215,518,0.415,21,77,0.273,194,441,0.44,0.435,155,191,0.812,41,115,156,91,46,2,79,65,606,OOR
Ryan Stack,PF,23,18,199,14,37,0.378,0,0,0.0,14,37,0.378,0.378,19,20,0.95,19,15,34,5,2,11,9,31,47,OOR
Jerry Stackhouse,SG,24,42,1188,181,488,0.371,35,126,0.278,146,362,0.403,0.407,210,247,0.85,26,81,107,118,34,19,121,79,607,OOR
John Starks,SG,33,50,1686,269,728,0.37,78,269,0.29,191,459,0.416,0.423,74,100,0.74,33,130,163,235,69,5,83,135,690,OOR
Vladimir Stepania,C,22,23,313,53,125,0.424,0,3,0.0,53,122,0.434,0.424,21,40,0.525,27,48,75,12,10,23,32,58,127,OOR
Michael Stewart,C,23,42,394,22,53,0.415,0,0,0.0,22,53,0.415,0.415,17,25,0.68,43,56,99,5,4,28,12,76,61,OOR
Bryant Stith,SG,28,46,1194,114,290,0.393,31,106,0.292,83,184,0.451,0.447,61,71,0.859,30,77,107,82,28,15,45,65,320,OOR
John Stockton,PG,36,50,1410,200,410,0.488,16,50,0.32,184,360,0.511,0.507,137,169,0.811,31,115,146,374,81,13,110,107,553,OOR
Peja Stojaković,SF,21,48,1025,141,373,0.378,57,178,0.32,84,195,0.431,0.454,63,74,0.851,43,100,143,72,41,7,53,43,402,OOR
Damon Stoudamire,PG,25,50,1673,249,629,0.396,44,142,0.31,205,487,0.421,0.431,89,122,0.73,41,126,167,312,49,4,110,81,631,OOR
Erick Strickland,SG,25,33,567,89,221,0.403,18,59,0.305,71,162,0.438,0.443,53,65,0.815,12,71,83,64,40,2,36,44,249,OOR
Mark Strickland,PF,28,32,357,50,101,0.495,0,1,0.0,50,100,0.5,0.495,19,26,0.731,26,52,78,9,7,8,13,28,119,OOR
Rod Strickland,PG,32,44,1632,251,603,0.416,12,42,0.286,239,561,0.426,0.426,176,236,0.746,56,156,212,434,76,5,142,91,690,OOR
Derek Strong,PF,30,44,695,76,180,0.422,0,2,0.0,76,178,0.427,0.422,71,99,0.717,66,95,161,17,15,7,37,64,223,OOR
Bruno Šundov,C,18,3,11,2,7,0.286,0,0,0.0,2,7,0.286,0.286,0,0,0.0,0,0,0,1,0,0,1,4,4,OOR
Bob Sura,PG,25,50,841,70,210,0.333,9,45,0.2,61,165,0.37,0.355,65,103,0.631,21,81,102,152,46,14,67,98,214,OOR
Johnny Taylor,SF,24,36,724,82,198,0.414,26,68,0.382,56,130,0.431,0.48,17,23,0.739,30,71,101,24,28,17,34,97,207,OOR
Maurice Taylor,PF,22,46,1505,311,675,0.461,1,6,0.167,310,669,0.463,0.461,150,206,0.728,100,142,242,67,16,29,120,179,773,OOR
John Thomas,C,23,39,593,71,123,0.577,0,1,0.0,71,122,0.582,0.577,27,48,0.563,65,69,134,15,17,9,21,82,169,OOR
Kurt Thomas,PF,26,50,1182,170,368,0.462,0,1,0.0,170,367,0.463,0.462,66,108,0.611,82,204,286,55,45,17,73,159,406,OOR
Tim Thomas,SF,21,50,812,132,279,0.473,21,68,0.309,111,211,0.526,0.511,73,112,0.652,49,77,126,46,26,12,46,107,358,OOR
Otis Thorpe,PF,36,49,1539,240,440,0.545,0,2,0.0,240,438,0.548,0.545,74,106,0.698,96,238,334,101,42,19,88,196,554,OOR
Robert Traylor,C,21,49,786,108,201,0.537,0,1,0.0,108,200,0.54,0.537,43,80,0.538,80,102,182,38,44,44,42,140,259,OOR
Gary Trent,PF,24,45,1362,287,602,0.477,0,5,0.0,287,597,0.481,0.477,145,235,0.617,127,224,351,77,29,23,66,122,719,OOR
Nick Van Exel,PG,27,50,1802,306,769,0.398,72,234,0.308,234,535,0.437,0.445,142,175,0.811,14,99,113,368,40,3,121,90,826,OOR
Keith Van Horn,PF,23,42,1576,322,752,0.428,16,53,0.302,306,699,0.438,0.439,256,298,0.859,114,244,358,65,43,53,133,134,916,OOR
David Vaughn,PF,25,10,103,13,24,0.542,0,0,0.0,13,24,0.542,0.542,8,10,0.8,13,21,34,1,2,8,11,22,34,OOR
Jacque Vaughn,PG,23,19,87,11,30,0.367,2,8,0.25,9,22,0.409,0.4,20,24,0.833,1,10,11,12,5,0,14,14,44,OOR
Loy Vaught,PF,30,37,481,59,155,0.381,0,1,0.0,59,154,0.383,0.381,9,14,0.643,36,110,146,11,15,6,17,54,127,OOR
Stojko Vranković,C,35,2,12,1,4,0.25,0,0,0.0,1,4,0.25,0.25,0,0,0.0,4,2,6,0,0,0,0,2,2,OOR
Antoine Walker,PF,22,42,1549,303,735,0.412,65,176,0.369,238,559,0.426,0.456,113,202,0.559,106,253,359,130,63,28,119,142,784,OOR
Samaki Walker,PF,22,39,568,88,190,0.463,0,1,0.0,88,189,0.466,0.463,53,98,0.541,46,97,143,6,9,16,37,87,229,OOR
Ben Wallace,C,24,46,1231,115,199,0.578,0,0,0.0,115,199,0.578,0.578,47,132,0.356,137,247,384,18,50,90,36,111,277,OOR
John Wallace,SF,24,48,812,153,354,0.432,0,0,0.0,153,354,0.432,0.432,105,150,0.7,54,117,171,46,12,43,70,92,411,OOR
Rasheed Wallace,PF,24,49,1414,242,476,0.508,13,31,0.419,229,445,0.515,0.522,131,179,0.732,57,184,241,60,48,54,80,175,628,OOR
Rex Walters,SG,28,33,506,35,95,0.368,12,38,0.316,23,57,0.404,0.432,19,23,0.826,10,40,50,58,10,3,32,63,101,OOR
Charlie Ward,PG,28,50,1556,135,334,0.404,53,149,0.356,82,185,0.443,0.484,55,78,0.705,23,149,172,271,103,8,131,105,378,OOR
Eric Washington,SG,24,38,761,73,184,0.397,37,97,0.381,36,87,0.414,0.497,22,32,0.688,35,54,89,30,25,18,34,87,205,OOR
Jamie Watson,SF,26,3,18,1,2,0.5,0,0,0.0,1,2,0.5,0.5,0,0,0.0,0,1,1,1,0,0,1,1,2,OOR
Clarence Weatherspoon,SF,28,49,1040,141,264,0.534,0,0,0.0,141,264,0.534,0.534,115,143,0.804,72,171,243,34,28,17,61,107,397,OOR
Chris Webber,PF,25,42,1719,378,778,0.486,4,34,0.118,374,744,0.503,0.488,79,174,0.454,149,396,545,173,60,89,148,145,839,OOR
Bonzi Wells,SF,22,7,35,11,20,0.55,1,3,0.333,10,17,0.588,0.575,8,18,0.444,4,5,9,3,1,1,6,5,31,OOR
Bill Wennington,C,35,38,451,62,178,0.348,1,1,1.0,61,177,0.345,0.351,18,22,0.818,20,59,79,18,13,12,17,79,143,OOR
David Wesley,PG,28,50,1848,243,545,0.446,61,170,0.359,182,375,0.485,0.502,159,191,0.832,23,138,161,322,100,10,142,130,706,OOR
Doug West,SG,31,14,294,31,65,0.477,0,2,0.0,31,63,0.492,0.477,19,25,0.76,5,20,25,19,16,7,12,38,81,OOR
Mark West,C,38,49,499,22,59,0.373,0,0,0.0,22,59,0.373,0.373,16,45,0.356,49,76,125,13,4,22,17,81,60,OOR
DeJuan Wheat,PG,25,46,590,73,193,0.378,22,60,0.367,51,133,0.383,0.435,40,55,0.727,11,34,45,102,26,2,48,59,208,OOR
Tyson Wheeler,PG,23,1,3,1,1,1.0,1,1,1.0,0,0,0.0,1.5,1,2,0.5,0,0,0,2,0,0,0,1,4,OOR
Jahidi White,PF,22,20,191,17,32,0.531,0,0,0.0,17,32,0.531,0.531,15,35,0.429,23,35,58,1,3,11,16,39,49,OOR
Chris Whitney,PG,27,39,441,64,156,0.41,32,95,0.337,32,61,0.525,0.513,27,31,0.871,8,39,47,69,18,2,36,49,187,OOR
Dominique Wilkins,SF,39,27,252,50,132,0.379,5,19,0.263,45,113,0.398,0.398,29,42,0.69,30,41,71,16,4,1,23,19,134,OOR
Gerald Wilkins,SG,35,3,28,0,9,0.0,0,0,0.0,0,9,0.0,0.0,2,2,1.0,0,1,1,1,0,0,3,3,2,OOR
Aaron Williams,PF,27,40,458,52,123,0.423,0,1,0.0,52,122,0.426,0.423,54,74,0.73,54,74,128,22,14,24,30,75,158,OOR
Alvin Williams,PG,24,50,1051,95,237,0.401,14,42,0.333,81,195,0.415,0.43,44,52,0.846,19,63,82,130,51,12,56,94,248,OOR
Brandon Williams,SG,23,3,4,0,0,0.0,0,0,0.0,0,0,0.0,0.0,2,4,0.5,1,0,1,0,0,0,0,0,2,OOR
Eric Williams,SF,26,38,780,80,219,0.365,6,26,0.231,74,193,0.383,0.379,111,139,0.799,34,47,81,37,27,8,49,76,277,OOR
Herb Williams,C,40,6,34,4,8,0.5,0,0,0.0,4,8,0.5,0.5,2,2,1.0,3,3,6,0,0,2,2,2,10,OOR
Hot Rod Williams,C,36,25,403,11,33,0.333,0,0,0.0,11,33,0.333,0.333,7,10,0.7,36,47,83,15,13,18,13,49,29,OOR
Jason Williams,PG,23,50,1805,231,617,0.374,100,323,0.31,131,294,0.446,0.455,79,105,0.752,14,139,153,299,95,1,143,91,641,OOR
Jayson Williams,C,30,30,1020,97,218,0.445,0,2,0.0,97,216,0.449,0.445,48,85,0.565,147,213,360,33,24,60,46,126,242,OOR
Jerome Williams,PF,25,50,1154,124,248,0.5,0,0,0.0,124,248,0.5,0.5,107,159,0.673,158,191,349,23,63,7,41,108,355,OOR
Micheal Williams,PG,32,2,15,1,5,0.2,0,0,0.0,1,5,0.2,0.2,0,0,0.0,1,0,1,0,0,0,1,1,2,OOR
Monty Williams,SF,27,1,6,0,2,0.0,0,0,0.0,0,2,0.0,0.0,1,2,0.5,0,0,0,0,0,0,0,0,1,OOR
Scott Williams,C,30,7,46,5,17,0.294,0,0,0.0,5,17,0.294,0.294,4,7,0.571,3,11,14,1,3,2,4,9,14,OOR
Shammond Williams,PG,23,2,4,0,1,0.0,0,0,0.0,0,1,0.0,0.0,3,4,0.75,0,0,0,1,0,0,0,0,3,OOR
Travis Williams,SF,29,8,62,6,13,0.462,0,0,0.0,6,13,0.462,0.462,3,4,0.75,6,13,19,2,2,1,6,10,15,OOR
Walt Williams,SF,28,48,1044,147,347,0.424,63,144,0.438,84,203,0.414,0.514,89,107,0.832,36,107,143,80,37,28,63,101,446,OOR
Corliss Williamson,SF,25,50,1374,269,555,0.485,1,5,0.2,268,550,0.487,0.486,120,188,0.638,85,121,206,66,30,8,75,118,659,OOR
Kevin Willis,C,36,42,1216,187,447,0.418,0,2,0.0,187,445,0.42,0.418,130,155,0.839,109,241,350,67,28,28,86,134,504,OOR
David Wingate,SG,35,20,92,7,16,0.438,0,0,0.0,7,16,0.438,0.438,0,0,0.0,3,5,8,5,4,0,6,10,14,OOR
Trevor Winter,C,25,1,5,0,0,0.0,0,0,0.0,0,0,0.0,0.0,0,0,0.0,1,2,3,0,0,0,0,5,0,OOR
Joe Wolf,PF,34,3,12,0,1,0.0,0,0,0.0,0,1,0.0,0.0,0,2,0.0,0,1,1,0,0,0,0,6,0,OOR
Haywoode Workman,PG,33,29,815,73,170,0.429,17,47,0.362,56,123,0.455,0.479,37,47,0.787,14,88,102,172,32,1,63,53,200,OOR
Lorenzen Wright,C,23,48,1135,119,260,0.458,0,1,0.0,119,259,0.459,0.458,81,117,0.692,142,219,361,33,26,36,48,162,319,OOR
Korleone Young,SF,20,3,15,5,10,0.5,1,4,0.25,4,6,0.667,0.55,2,2,1.0,2,2,4,1,0,0,1,3,13,OOR
