Player,Pos,Age,G,MP,FG,FGA,FG%,3P,3PA,3P%,2P,2PA,2P%,eFG%,FT,FTA,FT%,ORB,DRB,TRB,AST,STL,BLK,TOV,PF,PTS,Status
Shareef Abdur-Rahim,PF,27,85,2684,501,1054,0.475,9,34,0.265,492,1020,0.482,0.48,373,429,0.869,189,450,639,174,68,37,184,222,1384,OOR
Malik Allen,PF,25,45,616,83,198,0.419,0,0,0.0,83,198,0.419,0.419,25,33,0.758,42,77,119,16,12,28,27,81,191,OOR
Ray Allen,SG,28,56,2152,447,1017,0.44,148,378,0.392,299,639,0.468,0.512,245,271,0.904,69,217,286,268,71,11,156,132,1287,OOR
Rafer Alston,PG,27,82,2581,287,764,0.376,161,434,0.371,126,330,0.382,0.481,103,134,0.769,26,200,226,372,114,18,128,212,838,OOR
Chris Andersen,PF,25,71,1029,90,203,0.443,0,1,0.0,90,202,0.446,0.443,63,107,0.589,89,209,298,35,34,114,48,119,243,OOR
Derek Anderson,SG,29,51,1810,230,612,0.376,79,259,0.305,151,353,0.428,0.44,155,188,0.824,26,156,182,228,66,3,90,79,694,OOR
Kenny Anderson,PG,33,44,905,113,256,0.441,1,4,0.25,112,252,0.444,0.443,35,48,0.729,19,62,81,125,26,5,50,73,262,OOR
Shandon Anderson,SG,30,80,1974,238,564,0.422,36,128,0.281,202,436,0.463,0.454,123,161,0.764,53,169,222,122,68,17,118,182,635,OOR
Carmelo Anthony,SF,19,82,2995,624,1465,0.426,69,214,0.322,555,1251,0.444,0.449,408,525,0.777,183,315,498,227,97,41,247,225,1725,OOR
Robert Archibald,C-PF,23,32,256,9,33,0.273,0,0,0.0,9,33,0.273,0.273,14,31,0.452,21,31,52,13,14,3,10,50,32,OOR
Gilbert Arenas,PG,22,55,2066,358,914,0.392,125,333,0.375,233,581,0.401,0.46,237,317,0.748,55,199,254,275,103,12,226,176,1078,OOR
Brandon Armstrong,SG,23,56,434,65,175,0.371,19,52,0.365,46,123,0.374,0.426,2,4,0.5,12,31,43,14,12,2,24,49,151,OOR
Darrell Armstrong,PG,35,79,2247,291,736,0.395,135,429,0.315,156,307,0.508,0.487,123,144,0.854,63,163,226,311,133,16,155,148,840,OOR
Carlos Arroyo,PG,24,71,2008,339,768,0.441,38,117,0.325,301,651,0.462,0.466,181,225,0.804,41,144,185,355,63,5,156,165,897,OOR
Chucky Atkins,PG,29,64,1544,192,484,0.397,81,241,0.336,111,243,0.457,0.48,73,97,0.753,9,84,93,223,45,2,92,102,538,OOR
Stacey Augmon,SF,35,69,1416,143,347,0.412,1,7,0.143,142,340,0.418,0.414,110,139,0.791,52,122,174,85,55,15,76,114,397,OOR
Vin Baker,PF,32,54,1313,208,432,0.481,1,3,0.333,207,429,0.483,0.483,114,157,0.726,112,168,280,66,29,32,77,160,531,OOR
Marcus Banks,PG,22,81,1385,177,442,0.4,27,86,0.314,150,356,0.421,0.431,99,131,0.756,30,103,133,175,88,13,125,171,480,OOR
Leandro Barbosa,PG,21,70,1500,210,470,0.447,83,210,0.395,127,260,0.488,0.535,47,61,0.77,23,100,123,165,93,7,120,184,550,OOR
Matt Barnes,SF,23,38,724,63,138,0.457,2,13,0.154,61,125,0.488,0.464,43,61,0.705,53,98,151,48,27,3,44,76,171,OOR
Dana Barros,SG,36,1,11,2,3,0.667,0,0,0.0,2,3,0.667,0.667,2,2,1.0,0,0,0,0,0,0,0,2,6,OOR
Brent Barry,SG,32,59,1803,215,427,0.504,114,252,0.452,101,175,0.577,0.637,91,110,0.827,21,183,204,342,85,16,139,121,635,OOR
Jon Barry,SG,34,57,1101,120,297,0.404,51,138,0.37,69,159,0.434,0.49,60,71,0.845,25,98,123,147,57,8,53,66,351,OOR
Mengke Bateer,C,28,7,40,4,7,0.571,0,0,0.0,4,7,0.571,0.571,0,0,0.0,5,3,8,1,1,0,2,10,8,OOR
Tony Battie,C,27,73,1478,170,384,0.443,2,9,0.222,168,375,0.448,0.445,66,89,0.742,118,241,359,58,26,67,63,159,408,OOR
Shane Battier,SF,25,79,1947,242,543,0.446,65,186,0.349,177,357,0.496,0.506,120,164,0.732,102,201,303,101,101,58,56,187,669,OOR
Lonny Baxter,C-PF,25,62,766,103,209,0.493,1,3,0.333,102,206,0.495,0.495,44,76,0.579,64,123,187,20,17,29,38,123,251,OOR
Jerome Beasley,PF,23,2,5,1,3,0.333,0,0,0.0,1,3,0.333,0.333,0,0,0.0,0,1,1,0,0,0,0,0,2,OOR
Raja Bell,SG,27,82,2020,329,805,0.409,62,166,0.373,267,639,0.418,0.447,195,248,0.786,60,181,241,107,63,13,111,262,915,OOR
Troy Bell,PG,23,6,34,4,18,0.222,0,4,0.0,4,14,0.286,0.222,3,3,1.0,3,1,4,4,1,0,6,6,11,OOR
Jonathan Bender,SF,23,21,271,50,106,0.472,9,22,0.409,41,84,0.488,0.514,39,47,0.83,9,31,40,9,5,11,33,23,148,OOR
Travis Best,PG,31,61,762,64,172,0.372,3,20,0.15,61,152,0.401,0.381,40,46,0.87,17,51,68,112,31,4,33,66,171,OOR
Mike Bibby,PG,25,82,2980,527,1170,0.45,148,378,0.392,379,792,0.479,0.514,304,373,0.815,67,210,277,444,112,18,175,146,1506,OOR
Chauncey Billups,PG,27,78,2758,392,996,0.394,130,335,0.388,262,661,0.396,0.459,404,460,0.878,35,241,276,446,84,8,189,177,1318,OOR
Steve Blake,PG,23,75,1392,157,407,0.386,75,202,0.371,82,205,0.4,0.478,55,67,0.821,18,99,117,209,57,7,128,100,444,OOR
Corie Blount,PF-C,35,62,1050,115,253,0.455,0,3,0.0,115,250,0.46,0.455,15,27,0.556,98,177,275,55,49,24,43,135,245,OOR
Mark Blount,C,28,82,2402,342,604,0.566,0,0,0.0,342,604,0.566,0.566,159,221,0.719,207,382,589,75,80,106,150,253,843,OOR
Keith Bogans,SF,23,73,1787,183,454,0.403,67,187,0.358,116,267,0.434,0.477,65,103,0.631,106,211,317,98,46,10,75,128,498,OOR
Calvin Booth,C,27,71,1206,135,290,0.466,0,2,0.0,135,288,0.469,0.466,75,94,0.798,86,194,280,28,17,101,45,150,345,OOR
Carlos Boozer,PF,22,75,2592,471,900,0.523,1,6,0.167,470,894,0.526,0.524,219,285,0.768,230,627,857,148,74,55,134,199,1162,OOR
Curtis Borchardt,C,23,16,258,22,56,0.393,0,1,0.0,22,55,0.4,0.393,14,18,0.778,13,41,54,15,4,14,18,40,58,OOR
Chris Bosh,C,19,75,2510,327,712,0.459,5,14,0.357,322,698,0.461,0.463,202,288,0.701,191,366,557,78,59,106,107,215,861,OOR
Ruben Boumtje-Boumtje,C,25,9,26,1,5,0.2,0,0,0.0,1,5,0.2,0.2,2,2,1.0,0,1,1,1,0,1,0,2,4,OOR
Bruce Bowen,SF,32,82,2624,211,502,0.42,77,212,0.363,134,290,0.462,0.497,66,114,0.579,45,208,253,113,84,33,90,166,565,OOR
Ryan Bowen,PF,28,52,392,18,53,0.34,0,0,0.0,18,53,0.34,0.34,10,12,0.833,39,48,87,18,18,16,6,47,46,OOR
Earl Boykins,SG,27,82,1849,321,766,0.419,55,171,0.322,266,595,0.447,0.455,142,162,0.877,42,101,143,295,51,3,100,84,839,OOR
Michael Bradley,C-PF,24,16,98,7,15,0.467,0,0,0.0,7,15,0.467,0.467,1,2,0.5,6,17,23,1,3,0,7,14,15,OOR
Shawn Bradley,C,31,66,773,89,188,0.473,0,1,0.0,89,187,0.476,0.473,41,49,0.837,72,101,173,20,33,74,17,130,219,OOR
Torraye Braggs,PF,27,15,154,16,33,0.485,0,0,0.0,16,33,0.485,0.485,8,12,0.667,18,21,39,7,4,2,13,29,40,OOR
Elton Brand,PF,24,69,2670,484,982,0.493,0,1,0.0,484,981,0.493,0.493,411,532,0.773,269,445,714,227,64,154,193,229,1379,OOR
J.R. Bremer,PG,23,36,443,43,158,0.272,19,74,0.257,24,84,0.286,0.332,13,20,0.65,9,27,36,51,18,4,24,32,118,OOR
Jamison Brewer,PG,23,13,160,13,35,0.371,5,14,0.357,8,21,0.381,0.443,1,6,0.167,2,9,11,17,7,0,10,9,32,OOR
Primož Brezec,C,24,18,72,12,26,0.462,0,0,0.0,12,26,0.462,0.462,4,6,0.667,5,10,15,3,0,3,6,13,28,OOR
Damone Brown,PF,24,3,17,1,10,0.1,0,0,0.0,1,10,0.1,0.1,1,2,0.5,3,2,5,0,2,0,1,2,3,OOR
Devin Brown,SG,25,58,627,85,196,0.434,4,14,0.286,81,182,0.445,0.444,60,74,0.811,38,92,130,33,15,4,38,61,234,OOR
Kedrick Brown,SF,22,55,969,117,254,0.461,38,99,0.384,79,155,0.51,0.535,17,27,0.63,41,105,146,64,30,7,29,80,289,OOR
Kwame Brown,PF,21,74,2239,288,589,0.489,1,2,0.5,287,587,0.489,0.49,228,334,0.683,178,372,550,112,66,52,140,144,805,OOR
P.J. Brown,PF,34,80,2753,339,712,0.476,0,1,0.0,339,711,0.477,0.476,158,185,0.854,237,453,690,155,78,73,101,203,836,OOR
Tierre Brown,PG,24,3,17,2,4,0.5,0,0,0.0,2,4,0.5,0.5,2,4,0.5,0,1,1,2,0,0,7,1,6,OOR
Rick Brunson,PG,31,40,412,40,105,0.381,11,23,0.478,29,82,0.354,0.433,27,31,0.871,9,28,37,82,25,3,33,44,118,OOR
Kobe Bryant,SG,25,65,2447,516,1178,0.438,71,217,0.327,445,961,0.463,0.468,454,533,0.852,103,256,359,330,112,28,171,176,1557,Candidate
Greg Buckner,SG,27,53,703,66,175,0.377,12,44,0.273,54,131,0.412,0.411,20,27,0.741,28,75,103,45,21,4,34,77,164,OOR
Rodney Buford,SF,26,22,141,19,56,0.339,0,2,0.0,19,54,0.352,0.339,3,6,0.5,6,9,15,7,6,1,4,9,41,OOR
Caron Butler,SF,23,68,2030,240,631,0.38,10,42,0.238,230,589,0.39,0.388,133,176,0.756,92,234,326,126,75,13,91,162,623,OOR
Mitchell Butler,SG,33,41,552,54,124,0.435,11,30,0.367,43,94,0.457,0.48,15,24,0.625,24,47,71,32,22,4,24,54,134,OOR
Rasual Butler,SF,24,45,675,119,250,0.476,50,108,0.463,69,142,0.486,0.576,16,21,0.762,4,57,61,23,10,13,28,72,304,OOR
Žarko Čabarkapa,PF,22,49,570,81,197,0.411,6,32,0.188,75,165,0.455,0.426,35,53,0.66,26,73,99,40,10,13,54,75,203,OOR
Marcus Camby,C,29,72,2162,262,549,0.477,0,2,0.0,262,547,0.479,0.477,98,136,0.721,211,516,727,132,86,187,98,239,622,OOR
Elden Campbell,C,35,65,892,138,314,0.439,0,0,0.0,138,314,0.439,0.439,85,124,0.685,52,157,209,45,21,50,63,137,361,OOR
Brian Cardinal,PF,26,76,1634,220,466,0.472,55,124,0.444,165,342,0.482,0.531,238,271,0.878,100,217,317,103,66,20,84,206,733,OOR
Matt Carroll,SG,23,16,70,7,16,0.438,1,3,0.333,6,13,0.462,0.469,4,6,0.667,1,5,6,2,1,0,6,8,19,OOR
Anthony Carter,PG,28,5,87,11,37,0.297,0,3,0.0,11,34,0.324,0.297,0,0,0.0,2,9,11,12,4,0,12,9,22,OOR
Maurice Carter,SG,27,10,110,11,35,0.314,4,11,0.364,7,24,0.292,0.371,16,20,0.8,2,9,11,4,0,0,9,10,42,OOR
Vince Carter,SG,27,73,2785,608,1457,0.417,93,243,0.383,515,1214,0.424,0.449,336,417,0.806,95,254,349,348,88,65,223,212,1645,OOR
Sam Cassell,PG,34,81,2838,620,1270,0.488,74,186,0.398,546,1084,0.504,0.517,289,331,0.873,44,227,271,592,102,18,220,247,1603,OOR
Kelvin Cato,PF,29,69,1743,161,360,0.447,0,0,0.0,161,360,0.447,0.447,96,142,0.676,153,319,472,72,52,96,84,203,418,OOR
Tyson Chandler,PF,21,35,782,67,158,0.424,0,1,0.0,67,157,0.427,0.424,79,118,0.669,82,188,270,23,17,43,38,87,213,OOR
Calbert Cheaney,SF,32,79,2067,278,578,0.481,0,10,0.0,278,568,0.489,0.481,47,77,0.61,77,183,260,136,60,12,85,184,603,OOR
Doug Christie,SG,33,82,2780,317,688,0.461,49,142,0.345,268,546,0.491,0.496,148,172,0.86,69,260,329,347,151,41,155,186,831,OOR
Keon Clark,PF,28,2,27,2,6,0.333,0,0,0.0,2,6,0.333,0.333,0,0,0.0,1,6,7,1,1,0,0,1,4,OOR
Speedy Claxton,PG,25,60,1595,224,524,0.427,4,22,0.182,220,502,0.438,0.431,182,224,0.813,38,118,156,267,97,9,102,146,634,OOR
Mateen Cleaves,PG,26,4,92,7,23,0.304,0,1,0.0,7,22,0.318,0.304,1,2,0.5,1,6,7,19,4,2,5,13,15,OOR
Derrick Coleman,C,36,34,843,107,259,0.413,8,36,0.222,99,223,0.444,0.429,49,65,0.754,45,147,192,46,23,26,57,79,271,OOR
Bimbo Coles,PG,35,22,170,12,34,0.353,0,0,0.0,12,34,0.353,0.353,4,6,0.667,2,8,10,15,3,0,9,27,28,OOR
Jason Collier,C,26,20,545,79,165,0.479,1,4,0.25,78,161,0.484,0.482,67,85,0.788,36,75,111,17,11,11,31,71,226,OOR
Jarron Collins,C,25,81,1732,147,295,0.498,0,1,0.0,147,294,0.5,0.498,188,262,0.718,117,199,316,77,26,18,79,255,482,OOR
Jason Collins,C,25,78,2220,163,384,0.424,0,2,0.0,163,382,0.427,0.424,136,184,0.739,143,257,400,153,67,56,97,251,462,OOR
Brian Cook,C,23,35,442,67,141,0.475,0,5,0.0,67,136,0.493,0.475,21,28,0.75,31,70,101,20,16,16,17,64,155,OOR
Omar Cook,PG,22,17,139,7,27,0.259,0,1,0.0,7,26,0.269,0.259,0,0,0.0,3,3,6,24,10,0,10,14,14,OOR
Chris Crawford,PF,28,56,1207,211,471,0.448,44,113,0.389,167,358,0.466,0.495,103,119,0.866,58,117,175,45,37,20,55,131,569,OOR
Jamal Crawford,SG,23,80,2811,509,1318,0.386,165,521,0.317,344,797,0.432,0.449,200,240,0.833,46,237,283,405,111,29,193,161,1383,OOR
Austin Croshere,PF,28,77,1051,119,307,0.388,56,144,0.389,63,163,0.387,0.479,93,104,0.894,60,183,243,52,24,14,55,101,387,OOR
Eddy Curry,PF,21,73,2154,417,840,0.496,1,1,1.0,416,839,0.496,0.497,235,350,0.671,143,308,451,68,24,83,177,258,1070,OOR
Michael Curry,SF,35,70,1229,76,196,0.388,3,15,0.2,73,181,0.403,0.395,49,58,0.845,22,65,87,53,23,5,48,153,204,OOR
Samuel Dalembert,C,22,82,2197,270,499,0.541,0,1,0.0,270,498,0.542,0.541,112,174,0.644,194,432,626,21,44,189,86,273,652,OOR
Erick Dampier,C,28,74,2403,348,650,0.535,0,2,0.0,348,648,0.537,0.535,217,332,0.654,344,543,887,60,33,137,131,227,913,OOR
Antonio Daniels,PG,28,71,1512,187,398,0.47,42,116,0.362,145,282,0.514,0.523,155,184,0.842,23,119,142,298,45,6,61,64,571,OOR
Marquis Daniels,SG,23,56,1039,203,411,0.494,11,36,0.306,192,375,0.512,0.507,60,78,0.769,66,80,146,116,53,12,44,51,477,OOR
Antonio Davis,C,35,80,2570,266,660,0.403,0,0,0.0,266,660,0.403,0.403,176,230,0.765,207,464,671,137,37,65,114,206,708,OOR
Baron Davis,PG,24,67,2686,554,1402,0.395,187,582,0.321,367,820,0.448,0.462,237,352,0.673,66,221,287,501,158,27,215,178,1532,OOR
Dale Davis,C,34,76,1682,133,281,0.473,0,0,0.0,133,281,0.473,0.473,65,106,0.613,158,240,398,72,43,62,40,154,331,OOR
Hubert Davis,SG,33,17,78,1,11,0.091,0,1,0.0,1,10,0.1,0.091,2,2,1.0,2,6,8,4,2,0,3,12,4,OOR
Josh Davis,PF,23,4,23,2,5,0.4,0,2,0.0,2,3,0.667,0.4,1,1,1.0,1,4,5,0,0,0,2,3,5,OOR
Ricky Davis,SF-SG,24,79,2474,446,950,0.469,52,140,0.371,394,810,0.486,0.497,196,273,0.718,77,281,358,259,96,22,189,171,1140,OOR
Andrew DeClercq,C,30,71,1211,93,195,0.477,0,0,0.0,93,195,0.477,0.477,44,54,0.815,131,186,317,44,47,32,54,217,230,OOR
Tony Delk,SG,30,33,509,70,184,0.38,20,66,0.303,50,118,0.424,0.435,37,44,0.841,16,43,59,28,27,7,17,46,197,OOR
Derrick Dial,SG,28,9,86,9,28,0.321,2,9,0.222,7,19,0.368,0.357,6,8,0.75,5,8,13,2,6,0,1,6,26,OOR
Boris Diaw,SG,21,76,1919,140,313,0.447,6,26,0.231,134,287,0.467,0.457,56,93,0.602,111,231,342,182,59,37,126,191,342,OOR
Dan Dickau,PG,25,43,294,37,98,0.378,10,30,0.333,27,68,0.397,0.429,11,14,0.786,7,19,26,38,17,0,26,44,95,OOR
Kaniel Dickens,PF,25,3,12,3,3,1.0,0,0,0.0,3,3,1.0,1.0,1,2,0.5,2,0,2,0,0,0,1,3,7,OOR
DeSagana Diop,C,22,56,730,57,147,0.388,0,0,0.0,57,147,0.388,0.388,12,20,0.6,72,127,199,34,26,51,29,116,126,OOR
Vlade Divac,C,35,81,2317,314,668,0.47,2,13,0.154,312,655,0.476,0.472,170,260,0.654,136,327,463,432,57,77,173,222,800,OOR
Juan Dixon,SG,25,71,1478,247,637,0.388,59,198,0.298,188,439,0.428,0.434,111,139,0.799,30,118,148,137,82,4,104,111,664,OOR
Michael Doleac,C,26,72,1029,140,322,0.435,0,0,0.0,140,322,0.435,0.435,45,52,0.865,88,177,265,44,23,36,48,142,325,OOR
Keyon Dooling,PG,23,58,1137,137,352,0.389,8,46,0.174,129,306,0.422,0.401,78,94,0.83,17,62,79,130,45,6,65,108,360,OOR
Bryce Drew,PG,29,15,78,4,18,0.222,1,7,0.143,3,11,0.273,0.25,3,3,1.0,0,6,6,13,4,0,8,1,12,OOR
Predrag Drobnjak,C,28,61,949,149,379,0.393,11,36,0.306,138,343,0.402,0.408,73,86,0.849,54,142,196,39,22,24,48,85,382,OOR
Tim Duncan,PF,27,69,2527,592,1181,0.501,2,12,0.167,590,1169,0.505,0.502,352,588,0.599,227,632,859,213,62,185,183,164,1538,Candidate
Mike Dunleavy,SF,23,75,2336,323,720,0.449,94,254,0.37,229,466,0.491,0.514,137,185,0.741,87,355,442,220,68,13,143,169,877,OOR
Ronald Dupree,SF,23,47,893,111,282,0.394,4,9,0.444,107,273,0.392,0.401,66,105,0.629,55,112,167,55,32,18,51,134,292,OOR
Ndudi Ebi,SF,19,17,32,6,14,0.429,0,0,0.0,6,14,0.429,0.429,1,4,0.25,2,1,3,3,0,4,3,6,13,OOR
Howard Eisley,PG,31,67,1457,166,451,0.368,52,163,0.319,114,288,0.396,0.426,76,89,0.854,20,109,129,273,56,5,98,137,460,OOR
Francisco Elson,C,27,62,875,94,199,0.472,0,1,0.0,94,198,0.475,0.472,30,45,0.667,65,138,203,32,35,39,35,145,218,OOR
Melvin Ely,PF,25,42,510,66,153,0.431,0,1,0.0,66,152,0.434,0.431,25,42,0.595,48,53,101,22,9,17,20,68,157,OOR
Reggie Evans,PF,23,75,1280,67,165,0.406,0,3,0.0,67,162,0.414,0.406,83,148,0.561,156,252,408,33,54,10,65,176,217,OOR
Desmond Ferguson,SF,26,7,32,5,12,0.417,3,8,0.375,2,4,0.5,0.542,0,2,0.0,0,4,4,1,0,0,1,0,13,OOR
Michael Finley,SG,30,72,2778,514,1159,0.443,150,370,0.405,364,789,0.461,0.508,164,193,0.85,78,247,325,212,84,39,83,118,1342,OOR
Derek Fisher,SG,29,82,1769,203,576,0.352,52,179,0.291,151,397,0.38,0.398,122,153,0.797,30,122,152,187,103,4,79,115,580,OOR
Marcus Fizer,SF,25,46,738,134,350,0.383,2,17,0.118,132,333,0.396,0.386,90,120,0.75,61,141,202,43,16,8,51,97,360,OOR
Alton Ford,PF,22,9,41,6,11,0.545,0,0,0.0,6,11,0.545,0.545,3,6,0.5,3,8,11,3,0,1,3,9,15,OOR
T.J. Ford,PG,20,55,1472,153,398,0.384,5,21,0.238,148,377,0.393,0.391,80,98,0.816,37,140,177,356,60,3,139,123,391,OOR
Danny Fortson,C,27,56,625,71,139,0.511,0,0,0.0,71,139,0.511,0.511,75,92,0.815,114,136,250,9,12,11,37,148,217,OOR
Jeff Foster,C,27,82,1961,197,362,0.544,0,4,0.0,197,358,0.55,0.544,103,154,0.669,248,362,610,64,71,27,60,189,497,OOR
Tremaine Fowlkes,SF,27,36,261,15,48,0.313,1,8,0.125,14,40,0.35,0.323,13,18,0.722,18,35,53,14,9,3,12,37,44,OOR
Rick Fox,SF,34,38,846,73,186,0.392,15,61,0.246,58,125,0.464,0.433,22,30,0.733,29,73,102,98,29,4,48,99,183,OOR
Adonal Foyle,C,28,44,572,59,130,0.454,0,0,0.0,59,130,0.454,0.454,19,35,0.543,54,113,167,17,6,46,21,68,137,OOR
Richie Frahm,SF,26,54,469,63,139,0.453,34,92,0.37,29,47,0.617,0.576,23,26,0.885,12,44,56,24,16,4,7,50,183,OOR
Steve Francis,PG,26,79,3194,450,1117,0.403,73,250,0.292,377,867,0.435,0.436,337,435,0.775,116,317,433,493,139,35,294,257,1310,OOR
Hiram Fuller,PF,22,4,43,3,8,0.375,0,0,0.0,3,8,0.375,0.375,2,6,0.333,4,7,11,2,0,1,4,5,8,OOR
Dan Gadzuric,C,25,75,1260,183,349,0.524,0,1,0.0,183,348,0.526,0.524,58,118,0.492,126,220,346,28,51,105,45,186,424,OOR
Reece Gaines,PG,23,38,364,25,86,0.291,3,10,0.3,22,76,0.289,0.308,16,25,0.64,8,31,39,40,11,2,18,22,69,OOR
Alex Garcia,SG,23,2,13,1,7,0.143,0,0,0.0,1,7,0.143,0.143,1,2,0.5,0,0,0,0,2,0,1,0,3,OOR
Kevin Garnett,PF,27,82,3231,804,1611,0.499,11,43,0.256,793,1568,0.506,0.502,368,465,0.791,245,894,1139,409,120,178,212,202,1987,MVP
Pat Garrity,PF,27,2,22,1,3,0.333,0,0,0.0,1,3,0.333,0.333,0,0,0.0,0,0,0,1,0,0,0,2,2,OOR
Pau Gasol,PF,23,78,2458,506,1049,0.482,4,15,0.267,502,1034,0.485,0.484,365,511,0.714,206,394,600,198,44,132,187,185,1381,OOR
Devean George,SF,26,82,1951,233,571,0.408,65,186,0.349,168,385,0.436,0.465,73,96,0.76,87,245,332,112,81,38,88,189,604,OOR
Eddie Gill,PG,25,22,157,15,36,0.417,3,8,0.375,12,28,0.429,0.458,17,20,0.85,4,13,17,16,9,1,12,16,50,OOR
Kendall Gill,SG,35,56,1411,215,548,0.392,9,38,0.237,206,510,0.404,0.401,100,136,0.735,61,129,190,89,65,16,83,107,539,OOR
Manu Ginóbili,SG,26,77,2260,330,789,0.418,88,245,0.359,242,544,0.445,0.474,239,298,0.802,86,258,344,291,136,16,161,181,987,OOR
Gordan Giriček,SF-SG,26,73,2041,316,724,0.436,60,152,0.395,256,572,0.448,0.478,135,158,0.854,51,175,226,122,56,15,103,144,827,OOR
Dion Glover,SG,25,69,1643,230,589,0.39,40,119,0.336,190,470,0.404,0.424,120,156,0.769,58,208,266,130,50,19,102,123,620,OOR
Anthony Goldwire,PG,32,11,85,7,22,0.318,2,8,0.25,5,14,0.357,0.364,1,1,1.0,1,6,7,11,5,0,3,5,17,OOR
Drew Gooden,PF,22,79,2134,369,829,0.445,9,42,0.214,360,787,0.457,0.451,167,262,0.637,160,356,516,89,62,72,126,196,914,OOR
Brian Grant,C,31,76,2303,289,613,0.471,0,1,0.0,289,612,0.472,0.471,86,110,0.782,174,350,524,69,51,35,82,254,664,OOR
Horace Grant,PF,38,55,1106,92,224,0.411,0,1,0.0,92,223,0.413,0.411,39,54,0.722,79,154,233,71,24,21,29,70,223,OOR
Paul Grant,C,30,10,98,11,23,0.478,0,0,0.0,11,23,0.478,0.478,3,8,0.375,7,10,17,3,1,1,7,17,25,OOR
Willie Green,SG,22,53,767,143,357,0.401,19,61,0.311,124,296,0.419,0.427,59,81,0.728,16,49,65,53,26,5,59,83,364,OOR
Adrian Griffin,SG,29,19,133,5,18,0.278,1,2,0.5,4,16,0.25,0.306,0,4,0.0,1,18,19,10,7,2,3,17,11,OOR
Tom Gugliotta,PF,34,55,819,70,203,0.345,1,4,0.25,69,199,0.347,0.347,20,28,0.714,65,122,187,63,31,12,39,81,161,OOR
Marcus Haislip,PF,23,31,263,36,74,0.486,1,2,0.5,35,72,0.486,0.493,20,28,0.714,21,32,53,4,6,12,9,25,93,OOR
Darvin Ham,SF,30,54,484,37,75,0.493,1,2,0.5,36,73,0.493,0.5,21,35,0.6,47,46,93,16,13,8,31,63,96,OOR
Richard Hamilton,SG,25,78,2772,530,1166,0.455,18,68,0.265,512,1098,0.466,0.462,297,342,0.868,78,201,279,310,103,17,210,222,1375,OOR
Zendon Hamilton,C,28,46,473,51,95,0.537,0,0,0.0,51,95,0.537,0.537,67,96,0.698,49,97,146,13,8,8,27,74,169,OOR
Ben Handlogten,C,30,17,172,25,47,0.532,0,0,0.0,25,47,0.532,0.532,18,27,0.667,22,33,55,6,3,4,10,32,68,OOR
Travis Hansen,SF,25,41,507,46,130,0.354,9,30,0.3,37,100,0.37,0.388,22,27,0.815,30,40,70,19,10,9,15,67,123,OOR
Anfernee Hardaway,SG,32,76,2095,279,679,0.411,30,79,0.38,249,600,0.415,0.433,111,138,0.804,69,218,287,176,70,20,107,146,699,OOR
Matt Harpring,SF,27,31,1134,193,410,0.471,8,33,0.242,185,377,0.491,0.48,108,157,0.688,91,156,247,63,22,2,65,102,502,OOR
Al Harrington,PF,23,79,2441,421,909,0.463,21,77,0.273,400,832,0.481,0.475,185,252,0.734,163,345,508,131,80,22,163,250,1048,OOR
Othella Harrington,PF,30,56,872,100,202,0.495,0,0,0.0,100,202,0.495,0.495,58,78,0.744,58,119,177,29,12,14,65,134,258,OOR
Lucious Harris,PG,33,69,1504,187,463,0.404,38,101,0.376,149,362,0.412,0.445,66,78,0.846,39,101,140,135,41,2,53,74,478,OOR
Jason Hart,PG,25,53,660,71,159,0.447,2,9,0.222,69,150,0.46,0.453,33,43,0.767,10,69,79,81,28,5,29,59,177,OOR
Donnell Harvey,PF,23,60,783,89,201,0.443,0,3,0.0,89,198,0.449,0.443,61,83,0.735,48,116,164,21,24,27,45,129,239,OOR
Udonis Haslem,PF,23,75,1795,205,447,0.459,0,3,0.0,205,444,0.462,0.459,140,183,0.765,189,284,473,51,33,24,74,197,550,OOR
Trenton Hassell,SG,24,81,2264,177,381,0.465,4,13,0.308,173,368,0.47,0.47,48,61,0.787,68,189,257,133,36,54,46,200,406,OOR
Jarvis Hayes,SF,22,70,2044,278,695,0.4,40,131,0.305,238,564,0.422,0.429,77,98,0.786,71,193,264,106,71,11,110,157,673,OOR
Brendan Haywood,C,24,77,1484,200,388,0.515,0,1,0.0,200,387,0.517,0.515,137,234,0.585,186,201,387,43,32,100,80,154,537,OOR
Shane Heal,PG,33,6,72,7,24,0.292,4,18,0.222,3,6,0.5,0.375,4,5,0.8,1,3,4,5,1,0,5,2,22,OOR
Alan Henderson,PF,31,6,68,10,21,0.476,0,0,0.0,10,21,0.476,0.476,4,6,0.667,11,10,21,2,1,2,3,1,24,OOR
Nenê,PF,21,77,2504,334,630,0.53,0,2,0.0,334,628,0.532,0.53,240,352,0.682,154,349,503,168,116,41,183,280,908,OOR
Tyrone Hill,PF,35,5,38,3,5,0.6,0,0,0.0,3,5,0.6,0.6,3,4,0.75,5,3,8,0,0,1,2,10,9,OOR
Kirk Hinrich,PG,23,76,2706,318,823,0.386,144,369,0.39,174,454,0.383,0.474,135,168,0.804,42,217,259,517,101,21,204,276,915,OOR
Fred Hoiberg,SG,31,79,1804,178,383,0.465,76,172,0.442,102,211,0.483,0.564,98,116,0.845,21,247,268,109,66,10,44,136,530,OOR
Robert Horry,PF,33,81,1290,141,348,0.405,41,108,0.38,100,240,0.417,0.464,69,107,0.645,108,164,272,101,48,49,55,165,392,OOR
Eddie House,SG,25,60,1188,161,449,0.359,51,136,0.375,110,313,0.351,0.415,36,45,0.8,28,110,138,148,65,4,63,92,409,OOR
Allan Houston,SG,32,50,1799,340,781,0.435,87,202,0.431,253,579,0.437,0.491,157,172,0.913,20,101,121,99,38,2,102,105,924,OOR
Josh Howard,SF,23,67,1589,229,532,0.43,20,66,0.303,209,466,0.448,0.449,97,138,0.703,149,219,368,97,69,54,67,168,575,OOR
Juwan Howard,PF,30,81,2877,529,1169,0.453,0,1,0.0,529,1168,0.453,0.453,318,393,0.809,171,399,570,158,54,22,178,284,1376,OOR
Troy Hudson,PG,27,29,503,80,207,0.386,31,77,0.403,49,130,0.377,0.461,27,33,0.818,4,31,35,70,7,0,34,32,218,OOR
Larry Hughes,SG,25,61,2061,401,1009,0.397,79,232,0.341,322,777,0.414,0.437,267,335,0.797,96,230,326,148,95,26,152,147,1148,OOR
Ryan Humphrey,PF,24,2,11,1,4,0.25,0,1,0.0,1,3,0.333,0.25,0,0,0.0,2,1,3,1,1,0,2,3,2,OOR
Brandon Hunter,PF,23,36,406,53,116,0.457,0,3,0.0,53,113,0.469,0.457,19,43,0.442,50,68,118,19,13,1,22,40,125,OOR
Lindsey Hunter,SG,33,33,661,49,143,0.343,14,50,0.28,35,93,0.376,0.392,5,8,0.625,13,54,67,85,39,6,34,45,117,OOR
Steven Hunter,C,22,59,789,82,155,0.529,0,0,0.0,82,155,0.529,0.529,23,69,0.333,54,116,170,12,5,73,29,101,187,OOR
Zydrunas Ilgauskas,C,28,81,2539,466,965,0.483,2,7,0.286,464,958,0.484,0.484,303,406,0.746,279,374,653,109,39,201,163,277,1237,OOR
Allen Iverson,SG,28,48,2040,435,1125,0.387,57,199,0.286,378,926,0.408,0.412,339,455,0.745,34,144,178,324,115,5,209,87,1266,OOR
Bobby Jackson,SG,30,50,1185,263,592,0.444,81,219,0.37,182,373,0.488,0.513,82,109,0.752,55,119,174,105,49,8,63,106,689,OOR
Jim Jackson,SF,33,80,3119,382,900,0.424,162,405,0.4,220,495,0.444,0.514,107,127,0.843,52,435,487,226,86,23,175,227,1033,OOR
Marc Jackson,PF,29,22,598,71,171,0.415,0,1,0.0,71,170,0.418,0.415,64,81,0.79,45,81,126,18,12,6,24,45,206,OOR
Mark Jackson,PG,38,42,577,34,100,0.34,7,41,0.171,27,59,0.458,0.375,28,39,0.718,10,60,70,119,17,1,53,41,103,OOR
Stephen Jackson,SF,25,80,2940,536,1261,0.425,145,427,0.34,391,834,0.469,0.483,233,297,0.785,97,273,370,244,142,20,223,216,1450,OOR
Casey Jacobsen,SF,22,78,1828,150,360,0.417,75,180,0.417,75,180,0.417,0.521,91,111,0.82,42,159,201,98,48,9,68,144,466,OOR
Jerome James,C,28,65,990,129,259,0.498,0,0,0.0,129,259,0.498,0.498,66,100,0.66,78,152,230,32,20,60,82,180,324,OOR
LeBron James,SG,19,79,3122,622,1492,0.417,63,217,0.29,559,1275,0.438,0.438,347,460,0.754,99,333,432,465,130,58,273,149,1654,OOR
Mike James,PG,28,81,2196,272,657,0.414,106,281,0.377,166,376,0.441,0.495,103,127,0.811,28,206,234,339,96,3,124,156,753,OOR
Antawn Jamison,SF,27,82,2376,488,913,0.535,16,40,0.4,472,873,0.541,0.543,220,294,0.748,233,287,520,70,83,30,81,174,1212,OOR
Marko Jarić,PG,25,58,1760,185,477,0.388,51,150,0.34,134,327,0.41,0.441,74,101,0.733,44,131,175,281,93,20,115,132,495,OOR
Chris Jefferies,SF-SG,23,21,195,27,72,0.375,17,42,0.405,10,30,0.333,0.493,13,20,0.65,5,24,29,7,4,7,19,36,84,OOR
Richard Jefferson,SF,23,82,3133,555,1115,0.498,48,132,0.364,507,983,0.516,0.519,357,468,0.763,109,355,464,315,92,28,198,224,1515,OOR
Jared Jeffries,PF,22,82,1913,177,469,0.377,5,30,0.167,172,439,0.392,0.383,105,171,0.614,180,244,424,93,48,28,107,212,464,OOR
Britton Johnsen,C,24,20,290,17,59,0.288,1,12,0.083,16,47,0.34,0.297,7,16,0.438,15,30,45,12,7,1,14,28,42,OOR
Anthony Johnson,PG,29,73,1598,167,411,0.406,41,122,0.336,126,289,0.436,0.456,75,94,0.798,28,102,130,202,64,8,75,138,450,OOR
Avery Johnson,PG,38,46,637,80,199,0.402,0,3,0.0,80,196,0.408,0.402,52,78,0.667,3,30,33,111,26,3,51,34,212,OOR
DerMarr Johnson,SF,23,21,287,36,97,0.371,13,36,0.361,23,61,0.377,0.438,28,31,0.903,5,34,39,11,8,7,16,32,113,OOR
Ervin Johnson,C,36,66,965,55,103,0.534,0,1,0.0,55,102,0.539,0.534,17,28,0.607,61,171,232,24,27,43,30,156,127,OOR
Joe Johnson,SG,22,82,3331,555,1291,0.43,83,272,0.305,472,1019,0.463,0.462,174,232,0.75,80,305,385,362,93,26,199,177,1367,OOR
Linton Johnson,SF,23,41,734,72,203,0.355,7,33,0.212,65,170,0.382,0.372,22,37,0.595,59,124,183,27,37,32,37,90,173,OOR
Dahntay Jones,SG,23,20,154,15,53,0.283,1,4,0.25,14,49,0.286,0.292,5,11,0.455,7,16,23,12,5,6,12,23,36,OOR
Damon Jones,PG,27,82,2016,210,524,0.401,98,273,0.359,112,251,0.446,0.494,55,72,0.764,15,155,170,478,30,4,103,92,573,OOR
Eddie Jones,SG,32,81,2998,473,1156,0.409,177,479,0.37,296,677,0.437,0.486,278,333,0.835,38,270,308,258,92,34,129,226,1401,OOR
Fred Jones,SG,24,81,1508,123,311,0.395,27,89,0.303,96,222,0.432,0.439,124,149,0.832,25,101,126,173,65,18,73,132,397,OOR
James Jones,SF,23,6,26,2,9,0.222,1,4,0.25,1,5,0.2,0.278,2,2,1.0,0,2,2,0,1,0,0,1,7,OOR
Jumaine Jones,SG,24,42,373,33,96,0.344,13,44,0.295,20,52,0.385,0.411,14,23,0.609,24,44,68,14,12,9,19,48,93,OOR
Popeye Jones,PF,33,5,10,0,2,0.0,0,0,0.0,0,2,0.0,0.0,0,0,0.0,1,0,1,0,0,0,0,2,0,OOR
Chris Kaman,C,21,82,1843,200,435,0.46,0,2,0.0,200,433,0.462,0.46,99,142,0.697,126,335,461,85,23,73,155,211,499,OOR
Jason Kapono,SF,22,41,427,52,129,0.403,21,44,0.477,31,85,0.365,0.484,20,24,0.833,19,36,55,14,13,2,21,41,145,OOR
Jason Kidd,PG,30,67,2450,368,959,0.384,94,293,0.321,274,666,0.411,0.433,206,249,0.827,85,343,428,618,122,14,214,110,1036,OOR
Andrei Kirilenko,PF,22,78,2895,412,931,0.443,68,201,0.338,344,730,0.471,0.479,392,496,0.79,226,403,629,244,150,215,215,174,1284,OOR
Kerry Kittles,SG,29,82,2842,434,959,0.453,97,276,0.351,337,683,0.493,0.503,107,136,0.787,56,271,327,206,125,40,95,144,1072,OOR
Brevin Knight,PG,28,56,1037,105,246,0.427,2,8,0.25,103,238,0.433,0.431,49,65,0.754,14,98,112,204,84,1,72,107,261,OOR
Kyle Korver,SF,22,74,882,115,327,0.352,81,207,0.391,34,120,0.283,0.476,19,24,0.792,30,81,111,40,25,8,41,102,330,OOR
Toni Kukoč,PF,35,73,1522,211,506,0.417,49,168,0.292,162,338,0.479,0.465,145,199,0.729,60,211,271,200,59,21,110,110,616,OOR
Christian Laettner,PF,34,48,984,119,256,0.465,6,21,0.286,113,235,0.481,0.477,40,50,0.8,50,182,232,89,37,28,42,102,284,OOR
Raef LaFrentz,C,27,17,328,57,124,0.46,8,40,0.2,49,84,0.583,0.492,10,13,0.769,30,49,79,24,8,13,11,47,132,OOR
Maciej Lampe,C,18,21,224,43,88,0.489,0,4,0.0,43,84,0.512,0.489,10,13,0.769,9,35,44,9,3,3,15,28,96,OOR
Sean Lampley,SF,24,10,63,13,20,0.65,0,0,0.0,13,20,0.65,0.65,8,12,0.667,2,9,11,2,0,1,3,2,34,OOR
Dan Langhi,SF,26,6,37,5,14,0.357,1,2,0.5,4,12,0.333,0.393,2,2,1.0,0,4,4,0,0,0,2,7,13,OOR
Rusty LaRue,PG,30,4,22,1,3,0.333,1,1,1.0,0,2,0.0,0.5,1,2,0.5,0,3,3,2,2,0,4,2,4,OOR
Voshon Lenard,SG,30,73,2233,394,933,0.422,106,289,0.367,288,644,0.447,0.479,144,182,0.791,46,154,200,151,61,12,101,177,1038,OOR
Quincy Lewis,SF,26,14,65,7,20,0.35,2,5,0.4,5,15,0.333,0.4,0,0,0.0,1,6,7,2,2,2,3,10,16,OOR
Rashard Lewis,SF,24,80,2931,535,1229,0.435,145,386,0.376,390,843,0.463,0.494,206,270,0.763,133,385,518,175,99,54,135,233,1421,OOR
Randy Livingston,PG,28,4,48,2,10,0.2,0,3,0.0,2,7,0.286,0.2,4,6,0.667,2,5,7,4,2,0,4,7,8,OOR
Raül López,PG,23,82,1617,223,517,0.431,25,85,0.294,198,432,0.458,0.456,101,117,0.863,24,131,155,305,62,2,174,200,572,OOR
Tyronn Lue,PG,26,76,2332,309,714,0.433,80,209,0.383,229,505,0.453,0.489,101,131,0.771,26,161,187,317,61,5,124,185,799,OOR
George Lynch,SF,33,78,1701,149,375,0.397,43,139,0.309,106,236,0.449,0.455,34,51,0.667,96,216,312,117,48,18,64,159,375,OOR
Mark Madsen,C,28,72,1246,101,204,0.495,0,6,0.0,101,198,0.51,0.495,57,118,0.483,134,138,272,28,33,18,47,175,259,OOR
Corey Maggette,SF,24,73,2628,453,1013,0.447,76,231,0.329,377,782,0.482,0.485,526,620,0.848,96,334,430,224,65,16,207,217,1508,OOR
Jamaal Magloire,C,25,82,2777,383,809,0.473,0,1,0.0,383,808,0.474,0.473,353,470,0.751,268,579,847,86,43,101,201,278,1119,OOR
Karl Malone,PF,40,42,1373,193,400,0.483,0,1,0.0,193,399,0.484,0.483,168,225,0.747,61,306,367,163,50,20,103,116,554,OOR
Stephon Marbury,PG,26,81,3254,598,1386,0.431,87,274,0.318,511,1112,0.46,0.463,356,436,0.817,58,205,263,719,129,9,249,172,1639,OOR
Shawn Marion,SF,25,79,3217,590,1341,0.44,90,265,0.34,500,1076,0.465,0.474,228,268,0.851,212,525,737,214,167,104,156,203,1498,OOR
Donyell Marshall,PF,30,82,2988,470,1020,0.461,131,325,0.403,339,695,0.488,0.525,134,182,0.736,210,598,808,122,93,124,117,247,1205,OOR
Darrick Martin,PG,32,16,172,20,67,0.299,6,26,0.231,14,41,0.341,0.343,9,9,1.0,2,5,7,23,2,1,7,23,55,OOR
Kenyon Martin,PF,26,65,2252,439,900,0.488,7,25,0.28,432,875,0.494,0.492,201,294,0.684,133,484,617,160,95,82,168,230,1086,OOR
Jamal Mashburn,SF,31,19,730,156,398,0.392,19,67,0.284,137,331,0.414,0.416,65,80,0.813,19,98,117,47,14,5,37,42,396,OOR
Desmond Mason,SF,26,82,2534,409,867,0.472,9,39,0.231,400,828,0.483,0.477,356,463,0.769,93,266,359,152,60,24,148,191,1183,OOR
Roger Mason,SG,23,26,328,32,98,0.327,13,39,0.333,19,59,0.322,0.393,19,22,0.864,1,30,31,26,11,6,20,36,96,OOR
Tony Massenburg,PF,36,59,789,104,219,0.475,0,1,0.0,104,218,0.477,0.475,43,63,0.683,57,131,188,29,14,18,45,144,251,OOR
Walter McCarty,PF,29,77,1900,203,523,0.388,137,366,0.374,66,157,0.42,0.519,62,82,0.756,28,211,239,124,72,22,91,179,605,OOR
Amal McCaskill,C,30,59,636,47,117,0.402,0,1,0.0,47,116,0.405,0.402,19,27,0.704,48,85,133,20,12,20,25,89,113,OOR
Jelani McCoy,C,26,2,12,0,0,0.0,0,0,0.0,0,0,0.0,0.0,0,0,0.0,1,3,4,0,0,0,1,4,0,OOR
Antonio McDyess,PF,29,42,927,126,268,0.47,0,0,0.0,126,268,0.47,0.47,38,69,0.551,70,187,257,36,37,24,57,117,290,OOR
Tracy McGrady,SG,24,67,2675,653,1566,0.417,174,513,0.339,479,1053,0.455,0.473,398,500,0.796,95,307,402,370,93,42,179,129,1878,OOR
Jeff McInnis,SG-PG,29,70,2365,334,747,0.447,46,127,0.362,288,620,0.465,0.478,114,143,0.797,33,143,176,430,72,6,120,163,828,OOR
Aaron McKie,SF,31,75,2112,265,577,0.459,75,172,0.436,190,405,0.469,0.524,84,111,0.757,45,208,253,195,85,23,103,142,689,OOR
Keith McLeod,PG,24,33,391,27,82,0.329,1,10,0.1,26,72,0.361,0.335,33,43,0.767,5,29,34,59,16,1,29,39,88,OOR
Stanislav Medvedenko,PF,24,68,1442,237,537,0.441,0,3,0.0,237,534,0.444,0.441,89,116,0.767,148,195,343,57,38,18,59,191,563,OOR
Ron Mercer,SG,27,39,516,90,211,0.427,2,7,0.286,88,204,0.431,0.431,13,17,0.765,10,39,49,22,14,5,26,37,195,OOR
Chris Mihm,C-PF,24,76,1330,186,381,0.488,0,0,0.0,186,381,0.488,0.488,110,166,0.663,156,257,413,21,37,63,90,208,482,OOR
Darius Miles,SF,22,79,2079,365,753,0.485,7,40,0.175,358,713,0.502,0.489,124,193,0.642,112,247,359,162,67,61,130,168,861,OOR
Darko Miličić,C,18,34,159,17,65,0.262,0,1,0.0,17,64,0.266,0.262,14,24,0.583,11,32,43,7,7,15,13,33,48,OOR
Andre Miller,PG,27,82,2838,430,941,0.457,12,65,0.185,418,876,0.477,0.463,342,411,0.832,127,239,366,501,142,25,215,194,1214,OOR
Brad Miller,PF,27,72,2621,373,731,0.51,12,38,0.316,361,693,0.521,0.518,256,329,0.778,191,552,743,312,68,86,144,247,1014,OOR
Mike Miller,SF,23,65,1770,270,616,0.438,80,215,0.372,190,401,0.474,0.503,102,141,0.723,42,174,216,232,59,14,107,162,722,OOR
Oliver Miller,C,33,48,506,53,100,0.53,0,1,0.0,53,99,0.535,0.53,15,23,0.652,46,84,130,36,19,26,33,91,121,OOR
Reggie Miller,SG,38,80,2254,260,594,0.438,134,334,0.401,126,260,0.485,0.551,146,165,0.885,18,170,188,249,65,11,68,96,800,OOR
Yao Ming,C,23,82,2692,535,1025,0.522,0,2,0.0,535,1023,0.523,0.522,361,446,0.809,197,538,735,122,22,156,204,273,1431,OOR
Cuttino Mobley,SG,28,80,3229,460,1081,0.426,164,420,0.39,296,661,0.448,0.501,176,217,0.811,40,322,362,258,107,33,180,179,1260,OOR
Nazr Mohammed,C,26,80,1611,246,472,0.521,0,0,0.0,246,472,0.521,0.521,100,169,0.592,178,296,474,36,55,52,96,195,592,OOR
Jérôme Moïso,PF,25,35,417,40,84,0.476,0,1,0.0,40,83,0.482,0.476,22,38,0.579,41,72,113,8,17,12,25,42,102,OOR
Mikki Moore,PF-C,28,32,395,50,99,0.505,0,0,0.0,50,99,0.505,0.505,30,35,0.857,29,55,84,19,7,13,22,65,130,OOR
Alonzo Mourning,C,33,12,215,33,71,0.465,0,0,0.0,33,71,0.465,0.465,30,34,0.882,8,19,27,8,2,6,10,32,96,OOR
Troy Murphy,PF,23,28,610,107,243,0.44,5,17,0.294,102,226,0.451,0.451,60,80,0.75,48,125,173,20,12,17,34,58,279,OOR
Lamond Murray,SF,30,33,518,76,215,0.353,21,60,0.35,55,155,0.355,0.402,24,35,0.686,14,76,90,28,15,7,38,47,197,OOR
Ronald Murray,PG,24,82,2021,389,915,0.425,67,229,0.293,322,686,0.469,0.462,168,235,0.715,45,159,204,205,81,28,149,158,1013,OOR
Tracy Murray,SF,32,7,35,3,12,0.25,2,5,0.4,1,7,0.143,0.333,0,1,0.0,3,2,5,1,1,0,2,3,8,OOR
Dikembe Mutombo,C,37,65,1494,141,295,0.478,0,0,0.0,141,295,0.478,0.478,81,119,0.681,145,292,437,25,17,123,54,141,363,OOR
Mamadou N'Diaye,C,28,28,366,27,69,0.391,0,0,0.0,27,69,0.391,0.391,44,59,0.746,43,69,112,0,8,25,18,59,98,OOR
Boštjan Nachbar,SF,23,45,516,47,132,0.356,23,63,0.365,24,69,0.348,0.443,21,29,0.724,8,62,70,30,14,14,23,72,138,OOR
Lee Nailon,PF-SF,28,57,780,147,327,0.45,0,3,0.0,147,324,0.454,0.45,47,58,0.81,64,79,143,38,15,8,45,93,341,OOR
Eduardo Nájera,SF,27,58,720,72,162,0.444,2,4,0.5,70,158,0.443,0.451,30,46,0.652,67,89,156,25,35,19,29,90,176,OOR
Steve Nash,PG,29,78,2612,397,845,0.47,104,257,0.405,293,588,0.498,0.531,230,251,0.916,59,173,232,687,67,8,209,139,1128,OOR
Rasho Nesterović,C,27,82,2353,328,700,0.469,0,0,0.0,328,700,0.469,0.469,54,114,0.474,257,376,633,114,51,165,107,247,710,OOR
Ira Newble,SF,29,64,1245,108,276,0.391,2,19,0.105,106,257,0.412,0.395,36,46,0.783,65,90,155,72,25,19,54,109,254,OOR
Moochie Norris,PG,30,66,847,80,217,0.369,20,58,0.345,60,159,0.377,0.415,54,71,0.761,10,55,65,121,44,5,64,51,234,OOR
Dirk Nowitzki,C,25,77,2915,605,1310,0.462,99,290,0.341,506,1020,0.496,0.5,371,423,0.877,90,580,670,207,92,104,135,216,1680,OOR
Jermaine O'Neal,PF,25,78,2788,608,1400,0.434,2,18,0.111,606,1382,0.438,0.435,348,460,0.757,193,585,778,164,59,199,181,248,1566,Candidate
Shaquille O'Neal,C,31,67,2464,554,948,0.584,0,0,0.0,554,948,0.584,0.584,331,676,0.49,246,523,769,196,34,166,195,225,1439,OOR
Charles Oakley,PF,40,7,25,2,6,0.333,0,0,0.0,2,6,0.333,0.333,5,6,0.833,0,5,5,2,0,0,1,8,9,OOR
Lamar Odom,PF,24,80,3003,485,1127,0.43,61,205,0.298,424,922,0.46,0.457,340,458,0.742,160,616,776,327,85,71,236,273,1371,OOR
Mehmet Okur,PF,24,71,1580,251,542,0.463,18,48,0.375,233,494,0.472,0.48,162,209,0.775,160,261,421,69,36,63,101,138,682,OOR
Kevin Ollie,PG,31,82,1401,95,257,0.37,4,9,0.444,91,248,0.367,0.377,147,176,0.835,23,147,170,234,51,8,81,119,341,OOR
Michael Olowokandi,C,28,43,925,121,285,0.425,0,0,0.0,121,285,0.425,0.425,36,61,0.59,78,167,245,24,16,68,54,137,278,OOR
Greg Ostertag,C,30,78,2153,208,437,0.476,0,1,0.0,208,436,0.477,0.476,113,195,0.579,221,357,578,123,30,139,99,228,529,OOR
Bo Outlaw,PF,32,82,1606,159,312,0.51,0,4,0.0,159,308,0.516,0.51,61,116,0.526,125,217,342,90,73,70,69,170,379,OOR
Travis Outlaw,PF,19,8,19,3,7,0.429,0,0,0.0,3,7,0.429,0.429,2,4,0.5,2,2,4,1,1,0,1,1,8,OOR
Doug Overton,PG,34,61,1033,99,245,0.404,3,23,0.13,96,222,0.432,0.41,23,31,0.742,16,70,86,138,26,2,58,89,224,OOR
Zaza Pachulia,C,19,59,664,68,175,0.389,0,0,0.0,68,175,0.389,0.389,58,90,0.644,69,105,174,13,21,12,34,87,194,OOR
Robert Pack,PG,34,26,220,22,52,0.423,0,0,0.0,22,52,0.423,0.423,5,6,0.833,4,14,18,27,12,1,16,20,49,OOR
Scott Padgett,PF,27,58,547,74,167,0.443,28,65,0.431,46,102,0.451,0.527,24,32,0.75,46,93,139,23,12,13,22,73,200,OOR
Milt Palacio,PG,25,59,1211,104,298,0.349,4,26,0.154,100,272,0.368,0.356,45,68,0.662,15,87,102,184,41,11,87,90,257,OOR
Jannero Pargo,PG,24,31,479,81,199,0.407,22,62,0.355,59,137,0.431,0.462,23,27,0.852,8,29,37,70,13,6,47,50,207,OOR
Tony Parker,PG,21,75,2577,423,946,0.447,62,199,0.312,361,747,0.483,0.48,191,272,0.702,43,194,237,411,61,7,179,148,1099,OOR
Cherokee Parks,C,31,12,64,4,10,0.4,0,0,0.0,4,10,0.4,0.4,4,6,0.667,4,6,10,1,0,3,2,7,12,OOR
Ruben Patterson,SF,28,73,1651,200,395,0.506,2,12,0.167,198,383,0.517,0.509,105,190,0.553,129,139,268,139,84,21,105,152,507,OOR
Sasha Pavlović,SF,20,79,1144,149,376,0.396,19,70,0.271,130,306,0.425,0.422,65,84,0.774,44,115,159,60,41,16,67,187,382,OOR
Gary Payton,PG,35,82,2825,482,1024,0.471,55,165,0.333,427,859,0.497,0.498,180,252,0.714,72,270,342,449,96,19,151,169,1199,OOR
Anthony Peeler,SG,34,75,1391,156,348,0.448,68,141,0.482,88,207,0.425,0.546,51,61,0.836,31,122,153,120,56,10,77,103,431,OOR
Desmond Penigar,PF,22,10,89,14,28,0.5,0,0,0.0,14,28,0.5,0.5,4,4,1.0,6,18,24,3,2,2,6,14,32,OOR
Kirk Penney,SG,23,2,18,1,6,0.167,1,3,0.333,0,3,0.0,0.25,0,0,0.0,0,1,1,1,1,0,3,1,3,OOR
Kendrick Perkins,C,19,10,35,8,15,0.533,0,0,0.0,8,15,0.533,0.533,6,9,0.667,5,9,14,3,0,2,5,6,22,OOR
Wesley Person,SG,32,58,1037,126,314,0.401,55,138,0.399,71,176,0.403,0.489,31,39,0.795,16,101,117,66,19,9,38,38,338,OOR
Morris Peterson,SF,26,82,2148,238,587,0.405,126,340,0.371,112,247,0.453,0.513,76,94,0.809,35,226,261,113,88,14,69,206,678,OOR
Eric Piatkowski,SF,33,49,703,72,191,0.377,43,122,0.352,29,69,0.42,0.49,14,16,0.875,10,63,73,26,16,5,29,42,201,OOR
Paul Pierce,SG,26,80,3099,602,1497,0.402,115,384,0.299,487,1113,0.438,0.441,517,631,0.819,69,453,522,410,131,52,303,234,1836,OOR
Mickaël Piétrus,PG,21,53,748,96,231,0.416,35,105,0.333,61,126,0.484,0.491,52,75,0.693,48,71,119,27,32,12,40,100,279,OOR
Scottie Pippen,SF,38,23,412,53,140,0.379,13,48,0.271,40,92,0.435,0.425,17,27,0.63,20,48,68,50,21,9,29,38,136,OOR
Zoran Planinić,SG,21,49,473,53,129,0.411,9,32,0.281,44,97,0.454,0.446,38,60,0.633,14,41,55,68,13,3,36,70,153,OOR
Scot Pollard,C,28,61,678,47,114,0.412,0,0,0.0,47,114,0.412,0.412,12,21,0.571,67,97,164,10,23,26,22,110,106,OOR
Olden Polynice,C,39,2,12,0,0,0.0,0,0,0.0,0,0,0.0,0.0,0,0,0.0,1,1,2,1,1,0,4,2,0,OOR
Mark Pope,PF,31,4,20,1,2,0.5,0,0,0.0,1,2,0.5,0.5,0,1,0.0,0,3,3,0,1,0,3,8,2,OOR
James Posey,SG,27,82,2451,368,770,0.478,112,290,0.386,256,480,0.533,0.551,278,335,0.83,92,311,403,122,137,40,112,248,1126,OOR
Vitaly Potapenko,C,28,65,1419,200,409,0.489,0,0,0.0,200,409,0.489,0.489,59,92,0.641,101,188,289,53,22,28,77,161,459,OOR
Tayshaun Prince,SF,23,82,2701,338,723,0.467,57,157,0.363,281,566,0.496,0.507,108,141,0.766,93,297,390,191,63,69,119,149,841,OOR
Joel Przybilla,C,24,17,347,18,50,0.36,0,0,0.0,18,50,0.36,0.36,13,31,0.419,32,79,111,7,5,17,18,53,49,OOR
Vladimir Radmanović,PF,23,77,2321,345,812,0.425,140,377,0.371,205,435,0.471,0.511,95,127,0.748,104,302,406,142,80,42,109,187,925,OOR
Zach Randolph,PF,22,81,3067,663,1368,0.485,1,5,0.2,662,1363,0.486,0.485,299,393,0.761,242,609,851,163,68,41,247,227,1626,OOR
Theo Ratliff,C,30,85,2664,266,549,0.485,0,0,0.0,266,549,0.485,0.485,140,217,0.645,195,419,614,71,54,307,120,300,672,OOR
Željko Rebrača,C,31,24,273,34,77,0.442,0,0,0.0,34,77,0.442,0.442,23,30,0.767,23,35,58,6,5,11,17,52,91,OOR
Michael Redd,SG,24,82,3021,633,1439,0.44,127,363,0.35,506,1076,0.47,0.484,383,441,0.868,118,289,407,185,81,6,116,152,1776,OOR
Glen Rice,SF,36,18,262,22,76,0.289,5,28,0.179,17,48,0.354,0.322,17,17,1.0,9,32,41,24,6,0,13,22,66,OOR
Jason Richardson,SG,23,78,2936,563,1284,0.438,77,273,0.282,486,1011,0.481,0.468,258,377,0.684,124,400,524,226,86,41,196,182,1461,OOR
Quentin Richardson,SG,23,65,2338,425,1068,0.398,120,341,0.352,305,727,0.42,0.454,151,204,0.74,146,268,414,139,67,19,141,130,1121,OOR
Luke Ridnour,PG,22,69,1114,145,350,0.414,27,80,0.338,118,270,0.437,0.453,65,79,0.823,35,73,108,163,52,7,80,105,382,OOR
Clifford Robinson,PF,37,82,2846,366,945,0.387,112,314,0.357,254,631,0.403,0.447,123,173,0.711,54,268,322,271,68,73,173,237,967,OOR
Eddie Robinson,SF,27,51,1024,157,326,0.482,1,5,0.2,156,321,0.486,0.483,28,43,0.651,27,77,104,58,33,10,45,57,343,OOR
Glenn Robinson,SF,31,42,1336,275,614,0.448,34,100,0.34,241,514,0.469,0.476,114,137,0.832,46,143,189,57,42,9,106,96,698,OOR
Rodney Rogers,PF,32,69,1409,207,505,0.41,50,152,0.329,157,353,0.445,0.459,75,98,0.765,100,207,307,137,59,27,98,183,539,OOR
Sean Rooks,C,34,55,595,54,151,0.358,0,1,0.0,54,150,0.36,0.358,33,37,0.892,24,73,97,29,14,10,22,89,141,OOR
Jalen Rose,PG-SF,31,66,2497,383,952,0.402,69,202,0.342,314,750,0.419,0.439,187,231,0.81,34,232,266,329,51,22,208,184,1022,OOR
Malik Rose,PF,29,67,1256,173,404,0.428,0,3,0.0,173,401,0.431,0.428,183,225,0.813,110,210,320,69,36,24,112,164,529,OOR
Michael Ruffin,PF,27,41,733,38,117,0.325,0,0,0.0,38,117,0.325,0.325,16,38,0.421,78,129,207,41,22,21,42,103,92,OOR
Kareem Rush,SG,23,72,1244,190,432,0.44,48,138,0.348,142,294,0.483,0.495,31,52,0.596,20,77,97,59,33,20,48,109,459,OOR
Bryon Russell,SF,33,72,945,98,244,0.402,43,112,0.384,55,132,0.417,0.49,50,65,0.769,32,114,146,71,32,12,37,110,289,OOR
John Salmons,SG,24,77,1603,161,416,0.387,50,147,0.34,111,269,0.413,0.447,71,92,0.772,38,158,196,134,62,16,77,122,443,OOR
Jamal Sampson,C,20,10,130,11,23,0.478,0,0,0.0,11,23,0.478,0.478,7,12,0.583,23,29,52,7,2,4,6,16,29,OOR
Daniel Santiago,C,27,54,708,78,163,0.479,0,0,0.0,78,163,0.479,0.479,61,90,0.678,35,97,132,24,19,21,32,98,217,OOR
Brian Scalabrine,PF,25,69,928,86,218,0.394,10,41,0.244,76,177,0.429,0.417,58,70,0.829,42,131,173,65,21,14,42,113,240,OOR
Ansu Sesay,SF,27,57,583,81,178,0.455,6,21,0.286,75,157,0.478,0.472,32,46,0.696,43,49,92,19,19,20,23,66,200,OOR
Paul Shirley,PF,26,7,86,10,23,0.435,0,1,0.0,10,22,0.455,0.435,1,3,0.333,8,8,16,4,1,1,9,9,21,OOR
Bobby Simmons,SF,23,56,1376,147,373,0.394,2,12,0.167,145,361,0.402,0.397,141,169,0.834,115,147,262,96,51,17,73,169,437,OOR
Brian Skinner,C,27,56,1577,255,513,0.497,0,0,0.0,255,513,0.497,0.497,79,138,0.572,119,292,411,49,30,61,78,165,589,OOR
Tamar Slay,SG,23,22,165,21,60,0.35,4,12,0.333,17,48,0.354,0.383,7,14,0.5,10,15,25,14,7,1,11,20,53,OOR
Jabari Smith,C,26,31,168,26,70,0.371,0,3,0.0,26,67,0.388,0.371,12,20,0.6,11,20,31,11,2,6,7,25,64,OOR
Joe Smith,PF,28,76,2254,311,708,0.439,1,5,0.2,310,703,0.441,0.44,207,241,0.859,230,413,643,78,47,94,82,209,830,OOR
Leon Smith,C,23,1,4,1,2,0.5,0,0,0.0,1,2,0.5,0.5,0,0,0.0,1,1,2,0,0,0,0,1,2,OOR
Steve Smith,SG,34,71,929,119,293,0.406,43,107,0.402,76,186,0.409,0.48,77,83,0.928,27,54,81,56,15,6,42,91,358,OOR
Theron Smith,SF,23,20,178,16,43,0.372,6,12,0.5,10,31,0.323,0.442,6,8,0.75,13,28,41,7,5,5,14,18,44,OOR
Eric Snow,PG,30,82,2966,295,715,0.413,2,18,0.111,293,697,0.42,0.414,252,316,0.797,62,219,281,563,97,6,187,213,844,OOR
Darius Songaila,PF,25,73,976,133,273,0.487,0,0,0.0,133,273,0.487,0.487,71,88,0.807,91,134,225,48,42,12,43,126,337,OOR
Latrell Sprewell,SF,33,82,3100,518,1266,0.409,99,299,0.331,419,967,0.433,0.448,240,295,0.814,56,254,310,286,88,21,158,101,1375,OOR
Jerry Stackhouse,SF,29,26,774,128,321,0.399,23,65,0.354,105,256,0.41,0.435,83,103,0.806,16,78,94,103,24,3,88,49,362,OOR
Vladimir Stepania,C,27,42,453,43,103,0.417,0,0,0.0,43,103,0.417,0.417,22,36,0.611,50,75,125,23,11,15,19,61,108,OOR
DeShawn Stevenson,SG-SF,22,80,2444,376,871,0.432,19,71,0.268,357,800,0.446,0.443,138,204,0.676,79,219,298,158,52,17,120,140,909,OOR
Michael Stewart,C-PF,28,25,147,5,12,0.417,0,0,0.0,5,12,0.417,0.417,3,4,0.75,8,21,29,0,2,10,3,34,13,OOR
Peja Stojaković,SF,26,81,3264,665,1386,0.48,240,554,0.433,425,832,0.511,0.566,394,425,0.927,91,417,508,173,108,14,153,159,1964,Candidate
Damon Stoudamire,PG,30,82,3118,408,1018,0.401,156,427,0.365,252,591,0.426,0.477,127,145,0.876,52,256,308,500,99,9,180,173,1099,OOR
Amar'e Stoudemire,PF,21,55,2025,411,865,0.475,1,5,0.2,410,860,0.477,0.476,310,435,0.713,157,339,496,78,64,89,177,188,1133,OOR
Erick Strickland,PG,30,43,571,79,196,0.403,29,66,0.439,50,130,0.385,0.477,44,51,0.863,13,58,71,90,26,2,54,63,231,OOR
Rod Strickland,PG,37,61,1197,150,353,0.425,10,36,0.278,140,317,0.442,0.439,72,98,0.735,34,121,155,244,35,11,85,76,382,OOR
Bruno Šundov,C,23,5,33,4,10,0.4,0,0,0.0,4,10,0.4,0.4,3,6,0.5,2,8,10,1,0,0,3,9,11,OOR
Bob Sura,SG,30,80,1663,202,485,0.416,21,79,0.266,181,406,0.446,0.438,171,226,0.757,100,226,326,233,62,14,105,158,596,OOR
Mike Sweetney,PF,21,42,494,69,140,0.493,0,1,0.0,69,139,0.496,0.493,42,58,0.724,68,89,157,14,18,12,32,57,180,OOR
Stromile Swift,PF,24,77,1528,268,571,0.469,1,4,0.25,267,567,0.471,0.47,190,262,0.725,141,237,378,38,56,118,88,188,727,OOR
Wally Szczerbiak,SF,26,28,622,106,236,0.449,20,46,0.435,86,190,0.453,0.492,53,64,0.828,24,64,88,33,12,1,28,42,285,OOR
Maurice Taylor,PF,27,75,2081,367,765,0.48,0,2,0.0,367,763,0.481,0.48,128,174,0.736,131,253,384,107,43,47,149,253,862,OOR
Jason Terry,PG,26,81,3018,499,1196,0.417,146,421,0.347,353,775,0.455,0.478,215,260,0.827,49,287,336,437,124,16,229,192,1359,OOR
Etan Thomas,C,25,79,1901,257,526,0.489,0,0,0.0,257,526,0.489,0.489,191,295,0.647,183,345,528,68,36,123,113,219,705,OOR
Kenny Thomas,PF,26,74,2699,381,813,0.469,1,5,0.2,380,808,0.47,0.469,243,323,0.752,261,489,750,111,82,33,172,219,1006,OOR
Kurt Thomas,PF,31,80,2548,392,829,0.473,0,3,0.0,392,826,0.475,0.473,106,127,0.835,145,517,662,149,56,80,132,298,890,OOR
Tim Thomas,SF,26,66,2089,363,813,0.446,73,194,0.376,290,619,0.468,0.491,171,218,0.784,64,256,320,124,64,20,116,196,970,OOR
Jamaal Tinsley,PG,25,52,1378,153,370,0.414,77,207,0.372,76,163,0.466,0.518,49,67,0.731,28,108,136,303,84,17,110,132,432,OOR
Robert Traylor,C,26,71,942,145,287,0.505,2,5,0.4,143,282,0.507,0.509,70,128,0.547,106,156,262,43,39,37,62,161,362,OOR
Gary Trent,C,29,68,1025,155,328,0.473,0,6,0.0,155,322,0.481,0.473,69,91,0.758,83,133,216,49,12,17,54,129,379,OOR
Jeff Trepagnier,SG,24,11,96,10,38,0.263,2,4,0.5,8,34,0.235,0.289,3,6,0.5,6,9,15,4,3,0,6,7,25,OOR
Cezary Trybański,C,24,7,15,0,4,0.0,0,0,0.0,0,4,0.0,0.0,1,2,0.5,0,1,1,0,1,1,2,3,1,OOR
Jake Tsakalidis,C,24,40,533,67,133,0.504,0,0,0.0,67,133,0.504,0.504,36,61,0.59,37,91,128,18,9,22,23,79,170,OOR
Nikoloz Tskitishvili,PF,20,39,307,40,122,0.328,3,11,0.273,37,111,0.333,0.34,23,29,0.793,24,39,63,10,6,8,17,50,106,OOR
Hedo Türkoğlu,SF,24,80,2073,262,645,0.406,101,241,0.419,161,404,0.399,0.484,114,161,0.708,52,306,358,154,80,32,94,165,739,OOR
Ime Udoka,SF,26,4,28,3,9,0.333,0,1,0.0,3,8,0.375,0.333,2,4,0.5,1,4,5,2,2,1,3,3,8,OOR
Nick Van Exel,PG,32,39,1255,187,479,0.39,46,150,0.307,141,329,0.429,0.438,70,99,0.707,16,88,104,206,20,2,78,57,490,OOR
Keith Van Horn,SF,28,72,2340,410,903,0.454,93,233,0.399,317,670,0.473,0.506,249,290,0.859,149,352,501,120,68,33,169,215,1162,OOR
Jacque Vaughn,PG,28,71,1271,107,277,0.386,3,20,0.15,104,257,0.405,0.392,53,68,0.779,12,104,116,195,44,2,84,126,270,OOR
Jake Voskuhl,C,26,66,1606,152,300,0.507,0,0,0.0,152,300,0.507,0.507,134,181,0.74,123,220,343,57,42,25,77,258,438,OOR
Slavko Vraneš,C,21,1,3,0,1,0.0,0,0,0.0,0,1,0.0,0.0,0,0,0.0,0,0,0,0,0,0,0,1,0,OOR
Dwyane Wade,PG,22,61,2126,371,798,0.465,16,53,0.302,355,745,0.477,0.475,233,312,0.747,85,162,247,275,86,34,196,140,991,OOR
Dajuan Wagner,SG,20,44,708,112,306,0.366,31,86,0.36,81,220,0.368,0.417,32,47,0.681,9,49,58,51,26,7,41,89,287,OOR
Antoine Walker,PF,27,82,2840,483,1129,0.428,82,305,0.269,401,824,0.487,0.464,103,186,0.554,198,486,684,369,65,65,202,212,1151,OOR
Samaki Walker,PF,27,33,418,38,99,0.384,0,2,0.0,38,97,0.392,0.384,29,44,0.659,42,70,112,6,9,11,15,54,105,OOR
Ben Wallace,C,29,81,3050,315,748,0.421,1,8,0.125,314,740,0.424,0.422,142,290,0.49,324,682,1006,138,143,246,123,162,773,OOR
Gerald Wallace,SF,21,37,337,32,89,0.36,0,2,0.0,32,87,0.368,0.36,11,24,0.458,35,39,74,19,14,14,8,37,75,OOR
John Wallace,SF,29,37,368,61,145,0.421,5,13,0.385,56,132,0.424,0.438,31,40,0.775,12,47,59,14,5,8,24,38,158,OOR
Rasheed Wallace,PF,29,68,2390,425,974,0.436,82,248,0.331,343,726,0.472,0.478,156,212,0.736,102,357,459,156,61,122,119,190,1088,OOR
Luke Walton,PF,23,72,730,65,153,0.425,13,39,0.333,52,114,0.456,0.467,31,44,0.705,39,88,127,113,28,8,44,70,174,OOR
Charlie Ward,PG,33,71,1252,160,390,0.41,84,206,0.408,76,184,0.413,0.518,20,27,0.741,12,132,144,215,64,11,96,107,424,OOR
Earl Watson,PG,24,81,1669,172,464,0.371,26,106,0.245,146,358,0.408,0.399,90,138,0.652,49,129,178,402,91,19,146,175,460,OOR
Clarence Weatherspoon,PF,33,52,868,104,211,0.493,0,1,0.0,104,210,0.495,0.493,53,72,0.736,74,130,204,30,30,15,35,75,261,OOR
Chris Webber,PF,30,23,831,174,421,0.413,1,5,0.2,173,416,0.416,0.414,81,114,0.711,48,152,200,105,31,20,60,76,430,OOR
Bonzi Wells,SG,27,72,1872,363,850,0.427,22,69,0.319,341,781,0.437,0.44,138,183,0.754,78,182,260,139,91,19,161,197,886,OOR
Jiří Welsch,SG,24,81,2179,262,612,0.428,69,181,0.381,193,431,0.448,0.484,153,206,0.743,60,236,296,183,101,7,129,176,746,OOR
David Wesley,SG,33,61,2001,311,800,0.389,92,285,0.323,219,515,0.425,0.446,137,182,0.753,28,106,134,175,71,14,100,147,851,OOR
David West,PF,23,71,930,108,228,0.474,0,2,0.0,108,226,0.478,0.474,57,80,0.713,117,180,297,60,27,28,48,117,273,OOR
Jahidi White,C,27,62,865,99,190,0.521,0,0,0.0,99,190,0.521,0.521,63,126,0.5,97,164,261,7,25,51,66,176,261,OOR
Rodney White,SF,23,72,985,215,468,0.459,33,87,0.379,182,381,0.478,0.495,78,104,0.75,44,121,165,60,32,20,78,105,541,OOR
Chris Whitney,PG,32,16,186,17,45,0.378,8,18,0.444,9,27,0.333,0.467,5,5,1.0,3,12,15,14,6,2,6,6,47,OOR
Chris Wilcox,C,21,65,1340,227,436,0.521,0,1,0.0,227,435,0.522,0.521,105,150,0.7,125,180,305,51,29,20,80,183,559,OOR
Mike Wilks,PG,24,26,145,17,36,0.472,6,10,0.6,11,26,0.423,0.556,10,12,0.833,3,13,16,17,3,0,7,15,50,OOR
Aaron Williams,C,32,72,1337,172,342,0.503,1,3,0.333,171,339,0.504,0.504,105,155,0.677,101,193,294,81,34,46,89,187,450,OOR
Alvin Williams,SG,29,56,1730,201,496,0.405,26,89,0.292,175,407,0.43,0.431,66,85,0.776,18,132,150,224,55,10,78,114,494,OOR
Eric Williams,SF,31,71,1886,231,598,0.386,35,127,0.276,196,471,0.416,0.416,215,283,0.76,65,221,286,120,70,9,88,180,712,OOR
Frank Williams,PG,23,56,714,80,208,0.385,18,60,0.3,62,148,0.419,0.428,41,48,0.854,8,45,53,121,25,6,63,58,219,OOR
Jason Williams,PG,28,72,2115,290,713,0.407,120,364,0.33,170,349,0.487,0.491,82,98,0.837,25,122,147,492,92,5,136,97,782,OOR
Jerome Williams,PF,30,68,1637,158,336,0.47,0,8,0.0,158,328,0.482,0.47,106,155,0.684,177,298,475,72,90,8,74,134,422,OOR
Mo Williams,SG,21,57,772,115,303,0.38,10,39,0.256,105,264,0.398,0.396,44,56,0.786,23,49,72,76,28,2,51,87,284,OOR
Scott Williams,C,35,43,527,90,186,0.484,2,3,0.667,88,183,0.481,0.489,16,27,0.593,38,94,132,17,20,16,16,95,198,OOR
Shammond Williams,SG-PG,28,53,763,87,232,0.375,30,100,0.3,57,132,0.432,0.44,51,58,0.879,9,51,60,116,37,2,47,62,255,OOR
Corliss Williamson,PF,30,79,1574,304,602,0.505,0,0,0.0,304,602,0.505,0.505,144,197,0.731,88,168,256,57,30,20,113,204,752,OOR
Kevin Willis,C,41,48,373,70,150,0.467,0,1,0.0,70,149,0.47,0.467,24,39,0.615,37,61,98,11,21,9,32,61,164,OOR
Loren Woods,C,25,38,506,44,96,0.458,0,0,0.0,44,96,0.458,0.458,33,55,0.6,65,69,134,10,11,19,26,52,121,OOR
Qyntel Woods,SF,22,62,673,88,237,0.371,10,29,0.345,78,208,0.375,0.392,38,60,0.633,46,90,136,46,20,14,52,88,224,OOR
Metta World Peace,SF,24,73,2714,468,1112,0.421,75,242,0.31,393,870,0.452,0.455,322,439,0.733,100,285,385,272,152,50,202,194,1333,OOR
Lorenzen Wright,C,28,65,1674,257,586,0.439,0,5,0.0,257,581,0.442,0.439,96,131,0.733,144,301,445,71,45,58,77,192,610,OOR
Wang Zhizhi,C,26,16,114,17,46,0.37,4,14,0.286,13,32,0.406,0.413,9,10,0.9,4,14,18,2,3,5,6,13,47,OOR
