Player,Pos,Age,G,MP,FG,FGA,FG%,3P,3PA,3P%,2P,2PA,2P%,eFG%,FT,FTA,FT%,ORB,DRB,TRB,AST,STL,BLK,TOV,PF,PTS,Status,Season
Shareef Abdur-Rahim,PF,28,54,1867,337,670,0.503,15,39,0.385,322,631,0.51,0.514,220,254,0.866,123,269,392,111,49,26,117,150,909,OOR,2005
Cory Alexander,SG,31,16,201,16,49,0.327,8,19,0.421,8,30,0.267,0.408,9,12,0.75,8,21,29,37,9,1,19,29,49,OOR,2005
Malik Allen,PF,26,36,519,84,177,0.475,0,0,0.0,84,177,0.475,0.475,26,28,0.929,40,59,99,18,9,22,18,53,194,OOR,2005
Ray Allen,SG,29,78,3064,640,1494,0.428,209,556,0.376,431,938,0.459,0.498,378,428,0.883,79,268,347,289,84,5,171,167,1867,OOR,2005
Tony Allen,SG,23,77,1262,184,387,0.475,12,31,0.387,172,356,0.483,0.491,112,152,0.737,85,136,221,64,76,24,77,156,492,OOR,2005
Rafer Alston,PG,28,80,2717,403,974,0.414,139,389,0.357,264,585,0.451,0.485,191,258,0.74,42,237,279,514,118,7,170,212,1136,OOR,2005
Chris Andersen,C,26,67,1430,191,358,0.534,0,3,0.0,191,355,0.538,0.534,131,190,0.689,137,273,410,71,14,100,64,144,513,OOR,2005
Derek Anderson,SG,30,47,1239,152,391,0.389,58,151,0.384,94,240,0.392,0.463,70,87,0.805,25,103,128,143,36,4,70,89,432,OOR,2005
Kenny Anderson,PG,34,43,743,85,201,0.423,6,13,0.462,79,188,0.42,0.438,27,37,0.73,24,64,88,103,33,0,49,87,203,OOR,2005
Shandon Anderson,SF-SG,31,66,1171,98,217,0.452,5,29,0.172,93,188,0.495,0.463,54,66,0.818,41,150,191,70,40,14,50,138,255,OOR,2005
Carmelo Anthony,SF,20,75,2608,530,1230,0.431,42,158,0.266,488,1072,0.455,0.448,456,573,0.796,141,285,426,194,68,30,224,229,1558,OOR,2005
Rafael Araújo,C,24,59,736,76,175,0.434,1,3,0.333,75,172,0.436,0.437,43,55,0.782,59,126,185,16,21,8,52,157,196,OOR,2005
Gilbert Arenas,PG,23,80,3274,656,1523,0.431,205,562,0.365,451,961,0.469,0.498,521,640,0.814,83,295,378,411,139,23,242,245,2038,OOR,2005
Trevor Ariza,SF,19,80,1382,172,389,0.442,3,13,0.231,169,376,0.449,0.446,121,174,0.695,89,153,242,85,70,18,73,150,468,OOR,2005
Darrell Armstrong,PG,36,66,988,89,277,0.321,28,111,0.252,61,166,0.367,0.372,58,68,0.853,35,80,115,178,45,8,67,92,264,OOR,2005
Carlos Arroyo,PG,25,70,1448,167,429,0.389,8,30,0.267,159,399,0.398,0.399,119,149,0.799,26,78,104,280,44,4,107,143,461,OOR,2005
Chucky Atkins,PG,30,82,2903,388,910,0.426,176,455,0.387,212,455,0.466,0.523,163,203,0.803,31,166,197,358,73,2,151,181,1115,OOR,2005
Stacey Augmon,SF,36,55,663,68,167,0.407,0,0,0.0,68,167,0.407,0.407,57,77,0.74,45,54,99,36,23,8,31,83,193,OOR,2005
Maurice Baker,PG,25,5,19,0,1,0.0,0,0,0.0,0,1,0.0,0.0,0,0,0.0,1,1,2,1,1,0,1,3,0,OOR,2005
Vin Baker,PF-C,33,27,204,13,42,0.31,0,1,0.0,13,41,0.317,0.31,9,17,0.529,17,22,39,10,2,4,17,38,35,OOR,2005
Marcus Banks,PG,23,81,1145,115,286,0.402,21,59,0.356,94,227,0.414,0.439,121,163,0.742,29,97,126,155,63,13,79,146,372,OOR,2005
Leandro Barbosa,PG,22,63,1087,168,354,0.475,51,139,0.367,117,215,0.544,0.547,55,69,0.797,32,98,130,126,30,7,87,127,442,OOR,2005
Matt Barnes,SF,24,43,715,62,151,0.411,5,22,0.227,57,129,0.442,0.427,35,58,0.603,49,84,133,57,30,7,45,80,164,OOR,2005
Andre Barrett,PG,22,38,483,45,124,0.363,14,52,0.269,31,72,0.431,0.419,14,19,0.737,11,29,40,69,19,1,27,51,118,OOR,2005
Brent Barry,SG,33,81,1742,194,459,0.423,100,280,0.357,94,179,0.525,0.532,113,135,0.837,29,161,190,178,39,20,64,123,601,OOR,2005
Jon Barry,SG,35,69,1505,161,368,0.438,71,165,0.43,90,203,0.443,0.534,62,71,0.873,26,133,159,167,60,9,67,95,455,OOR,2005
Tony Battie,C,28,81,1894,163,354,0.46,0,6,0.0,163,348,0.468,0.46,68,94,0.723,109,343,452,42,30,81,81,244,394,OOR,2005
Shane Battier,SG,26,80,2516,271,613,0.442,70,177,0.395,201,436,0.461,0.499,180,228,0.789,158,255,413,126,91,77,75,201,792,OOR,2005
Lonny Baxter,PF,26,4,36,3,11,0.273,0,0,0.0,3,11,0.273,0.273,0,2,0.0,4,4,8,0,0,0,4,10,6,OOR,2005
Raja Bell,SG,28,63,1790,303,667,0.454,54,134,0.403,249,533,0.467,0.495,112,150,0.747,48,153,201,91,44,8,79,205,772,OOR,2005
Jonathan Bender,SF,24,7,93,16,40,0.4,1,5,0.2,15,35,0.429,0.413,3,6,0.5,5,9,14,4,1,2,10,9,36,OOR,2005
Travis Best,PG,32,76,1461,190,452,0.42,26,85,0.306,164,367,0.447,0.449,108,122,0.885,19,88,107,143,66,9,67,148,514,OOR,2005
Mike Bibby,PG,26,80,3084,560,1264,0.443,131,364,0.36,429,900,0.477,0.495,320,413,0.775,77,255,332,541,124,30,203,191,1571,OOR,2005
Andris Biedriņš,C,18,30,384,45,78,0.577,0,1,0.0,45,77,0.584,0.577,19,40,0.475,47,71,118,12,12,24,12,87,109,OOR,2005
Chauncey Billups,PG,28,80,2866,404,913,0.442,165,387,0.426,239,526,0.454,0.533,343,382,0.898,48,223,271,464,81,9,180,194,1316,OOR,2005
Steve Blake,PG,24,44,648,61,186,0.328,36,93,0.387,25,93,0.269,0.425,33,41,0.805,18,53,71,69,13,0,39,47,191,OOR,2005
Mark Blount,C,29,82,2130,327,618,0.529,0,1,0.0,327,617,0.53,0.529,117,164,0.713,143,254,397,129,33,64,158,229,771,OOR,2005
Tony Bobbitt,SG,25,2,12,2,5,0.4,1,2,0.5,1,3,0.333,0.5,0,0,0.0,0,3,3,0,0,0,0,1,5,OOR,2005
Keith Bogans,SG,24,74,1791,262,688,0.381,57,173,0.329,205,515,0.398,0.422,133,183,0.727,76,150,226,135,68,8,122,167,714,OOR,2005
Matt Bonner,C,24,82,1553,247,463,0.533,39,92,0.424,208,371,0.561,0.576,56,71,0.789,108,177,285,48,39,19,40,220,589,OOR,2005
Calvin Booth,C,28,51,451,49,108,0.454,0,1,0.0,49,107,0.458,0.454,26,32,0.813,29,78,107,8,15,28,16,78,124,OOR,2005
Carlos Boozer,PF,23,51,1772,361,693,0.521,0,1,0.0,361,692,0.522,0.521,187,268,0.698,141,316,457,144,41,24,137,179,909,OOR,2005
Curtis Borchardt,C,24,67,859,74,172,0.43,0,0,0.0,74,172,0.43,0.43,52,71,0.732,86,138,224,49,10,32,52,160,200,OOR,2005
Chris Bosh,PF,20,81,3017,473,1005,0.471,3,10,0.3,470,995,0.472,0.472,412,542,0.76,194,524,718,153,76,113,187,226,1361,OOR,2005
Bruce Bowen,SF,33,82,2627,251,598,0.42,102,253,0.403,149,345,0.432,0.505,71,112,0.634,50,235,285,126,55,39,57,175,675,OOR,2005
Ryan Bowen,SF,29,66,604,47,111,0.423,3,6,0.5,44,105,0.419,0.437,14,21,0.667,21,55,76,18,23,5,7,61,111,OOR,2005
Earl Boykins,PG,28,82,2162,340,824,0.413,56,166,0.337,284,658,0.432,0.447,279,303,0.921,37,106,143,372,78,12,121,122,1015,OOR,2005
Michael Bradley,PF,25,18,119,15,24,0.625,0,1,0.0,15,23,0.652,0.625,3,8,0.375,8,20,28,5,1,2,5,12,33,OOR,2005
Shawn Bradley,C,32,77,885,84,186,0.452,0,0,0.0,84,186,0.452,0.452,43,63,0.683,70,144,214,15,25,63,33,153,211,OOR,2005
Torraye Braggs,PF,28,7,24,3,7,0.429,0,0,0.0,3,7,0.429,0.429,0,0,0.0,7,5,12,0,0,0,2,4,6,OOR,2005
Elton Brand,PF,25,81,3001,629,1251,0.503,0,3,0.0,629,1248,0.504,0.503,364,484,0.752,296,474,770,208,62,169,183,240,1622,OOR,2005
Jamison Brewer,PG,24,18,185,11,37,0.297,3,15,0.2,8,22,0.364,0.338,6,13,0.462,6,16,22,12,8,1,13,11,31,OOR,2005
Primož Brezec,C,25,72,2276,387,756,0.512,0,0,0.0,387,756,0.512,0.512,164,220,0.745,226,305,531,86,33,55,106,183,938,OOR,2005
Damone Brown,SF,25,14,152,23,62,0.371,4,11,0.364,19,51,0.373,0.403,4,9,0.444,10,18,28,14,1,6,15,17,54,OOR,2005
Devin Brown,SG,26,67,1238,173,409,0.423,45,121,0.372,128,288,0.444,0.478,103,130,0.792,37,139,176,92,39,12,53,83,494,OOR,2005
Kedrick Brown,SF,23,8,55,2,6,0.333,0,3,0.0,2,3,0.667,0.333,8,10,0.8,1,10,11,4,3,1,5,4,12,OOR,2005
Kwame Brown,PF,22,42,908,109,237,0.46,0,0,0.0,109,237,0.46,0.46,74,129,0.574,72,134,206,39,25,15,67,112,292,OOR,2005
P.J. Brown,PF,35,82,2817,338,758,0.446,0,0,0.0,338,758,0.446,0.446,210,243,0.864,266,471,737,178,74,50,101,233,886,OOR,2005
Tierre Brown,PG,25,76,1066,124,348,0.356,26,72,0.361,98,276,0.355,0.394,59,75,0.787,21,72,93,155,32,1,74,59,333,OOR,2005
Rick Brunson,PG,32,80,1945,166,442,0.376,48,130,0.369,118,312,0.378,0.43,57,74,0.77,23,164,187,410,82,7,125,106,437,OOR,2005
Kobe Bryant,SG,26,66,2689,573,1324,0.433,131,387,0.339,442,937,0.472,0.482,542,664,0.816,95,297,392,398,86,53,270,174,1819,OOR,2005
Greg Buckner,SG,28,70,1522,160,303,0.528,49,121,0.405,111,182,0.61,0.609,63,81,0.778,66,142,208,133,75,6,49,169,432,OOR,2005
Rodney Buford,SF,27,64,1313,187,489,0.382,34,108,0.315,153,381,0.402,0.417,37,45,0.822,33,156,189,63,40,4,35,101,445,OOR,2005
Antonio Burks,PG,24,24,219,28,60,0.467,3,11,0.273,25,49,0.51,0.492,14,19,0.737,1,11,12,28,13,1,12,25,73,OOR,2005
Caron Butler,SF,24,77,2746,441,991,0.445,38,125,0.304,403,866,0.465,0.464,275,319,0.862,146,304,450,146,110,23,125,213,1195,OOR,2005
Jackie Butler,C,19,3,5,4,4,1.0,0,0,0.0,4,4,1.0,1.0,2,2,1.0,0,0,0,0,1,0,1,0,10,OOR,2005
Rasual Butler,SF,25,65,1203,163,409,0.399,57,153,0.373,106,256,0.414,0.468,37,48,0.771,15,136,151,62,18,29,37,104,420,OOR,2005
Žarko Čabarkapa,PF,23,40,475,86,177,0.486,13,36,0.361,73,141,0.518,0.523,53,65,0.815,35,67,102,25,10,5,30,59,238,OOR,2005
Marcus Camby,C,30,66,2015,279,600,0.465,0,4,0.0,279,596,0.468,0.465,125,173,0.723,131,530,661,152,61,199,103,177,683,OOR,2005
Elden Campbell,C,36,40,390,39,123,0.317,0,2,0.0,39,121,0.322,0.317,42,55,0.764,28,65,93,19,8,7,29,57,120,OOR,2005
Brian Cardinal,PF,27,58,1433,160,432,0.37,44,125,0.352,116,307,0.378,0.421,158,181,0.873,63,162,225,114,88,19,83,172,522,OOR,2005
Geno Carlisle,SG,28,6,16,2,3,0.667,0,0,0.0,2,3,0.667,0.667,4,6,0.667,1,0,1,1,0,0,1,1,8,OOR,2005
Matt Carroll,SG,24,25,430,70,180,0.389,13,39,0.333,57,141,0.404,0.425,71,83,0.855,13,47,60,17,17,2,25,37,224,OOR,2005
Anthony Carter,PG,29,66,742,72,177,0.407,2,17,0.118,70,160,0.438,0.412,35,51,0.686,12,57,69,161,35,18,62,88,181,OOR,2005
Vince Carter,SF-SG,28,77,2828,696,1541,0.452,127,313,0.406,569,1228,0.463,0.493,367,460,0.798,106,295,401,327,109,48,168,243,1886,OOR,2005
Sam Cassell,PG,35,59,1522,319,687,0.464,27,103,0.262,292,584,0.5,0.484,134,155,0.865,25,132,157,301,36,14,109,160,799,OOR,2005
Kelvin Cato,C,30,62,1525,160,297,0.539,0,0,0.0,160,297,0.539,0.539,112,143,0.783,102,314,416,40,55,82,64,170,432,OOR,2005
Lionel Chalmers,PG,24,36,433,42,125,0.336,12,49,0.245,30,76,0.395,0.384,15,24,0.625,4,27,31,51,13,0,24,30,111,OOR,2005
Tyson Chandler,C,22,80,2189,207,419,0.494,0,2,0.0,207,417,0.496,0.494,226,336,0.673,261,514,775,65,69,141,118,268,640,OOR,2005
Calbert Cheaney,SG,33,55,951,113,265,0.426,0,3,0.0,113,262,0.431,0.426,24,37,0.649,32,92,124,64,17,15,35,95,250,OOR,2005
Josh Childress,SG,21,80,2376,302,642,0.47,13,56,0.232,289,586,0.493,0.481,190,231,0.823,195,287,482,151,74,35,106,184,807,OOR,2005
Doug Christie,SG,34,52,1525,130,332,0.392,15,62,0.242,115,270,0.426,0.414,70,78,0.897,38,139,177,199,80,18,104,106,345,OOR,2005
Speedy Claxton,PG,26,62,1866,257,611,0.421,11,61,0.18,246,550,0.447,0.43,187,254,0.736,37,147,184,374,109,8,119,184,712,OOR,2005
Mateen Cleaves,PG,27,14,65,5,14,0.357,0,2,0.0,5,12,0.417,0.357,3,4,0.75,2,4,6,7,2,0,2,2,13,OOR,2005
Derrick Coleman,C,37,5,50,3,14,0.214,0,2,0.0,3,12,0.25,0.214,3,3,1.0,3,12,15,0,0,0,2,6,9,OOR,2005
Jason Collier,C,27,70,942,174,376,0.463,6,14,0.429,168,362,0.464,0.471,48,71,0.676,84,100,184,18,15,13,63,147,402,OOR,2005
Jarron Collins,C,26,50,961,65,157,0.414,0,1,0.0,65,156,0.417,0.414,83,119,0.697,57,107,164,61,11,6,34,146,213,OOR,2005
Jason Collins,C,26,80,2542,186,451,0.412,2,6,0.333,184,445,0.413,0.415,137,209,0.656,153,335,488,105,71,71,91,322,511,OOR,2005
Nick Collison,C,24,82,1396,190,354,0.537,0,3,0.0,190,351,0.541,0.537,83,118,0.703,156,220,376,32,34,50,62,252,463,OOR,2005
Brian Cook,C,24,72,1087,176,422,0.417,78,199,0.392,98,223,0.439,0.509,28,37,0.757,63,153,216,35,23,26,29,139,458,OOR,2005
Omar Cook,PG,23,5,74,10,24,0.417,0,4,0.0,10,20,0.5,0.417,3,6,0.5,2,5,7,22,6,1,6,6,23,OOR,2005
Jamal Crawford,SG,24,70,2688,437,1097,0.398,185,512,0.361,252,585,0.431,0.483,182,216,0.843,33,170,203,302,92,19,148,135,1241,OOR,2005
Austin Croshere,PF,29,73,1827,188,497,0.378,45,174,0.259,143,323,0.443,0.424,226,256,0.883,103,272,375,98,48,17,104,154,647,OOR,2005
Eddy Curry,C,22,63,1808,393,730,0.538,0,0,0.0,393,730,0.538,0.538,226,314,0.72,116,222,338,37,21,58,163,202,1012,OOR,2005
Michael Curry,SF,36,18,249,13,29,0.448,0,0,0.0,13,29,0.448,0.448,4,8,0.5,8,19,27,15,5,4,5,39,30,OOR,2005
Samuel Dalembert,C,23,72,1785,250,477,0.524,0,0,0.0,250,477,0.524,0.524,89,148,0.601,187,355,542,35,46,121,114,241,589,OOR,2005
Erick Dampier,C,29,59,1609,202,367,0.55,0,3,0.0,202,364,0.555,0.55,138,228,0.605,183,318,501,51,15,80,102,205,542,OOR,2005
Antonio Daniels,PG,29,75,2026,273,623,0.438,49,165,0.297,224,458,0.489,0.478,248,304,0.816,20,149,169,309,51,3,78,78,843,OOR,2005
Erik Daniels,SF,22,21,72,6,18,0.333,1,2,0.5,5,16,0.313,0.361,0,0,0.0,7,11,18,4,2,0,6,7,13,OOR,2005
Marquis Daniels,SG,24,60,1412,220,504,0.437,7,35,0.2,213,469,0.454,0.443,98,133,0.737,87,129,216,128,83,14,86,124,545,OOR,2005
Antonio Davis,PF,36,72,1843,193,419,0.461,0,0,0.0,193,419,0.461,0.461,115,152,0.757,152,276,428,80,27,41,96,147,501,OOR,2005
Baron Davis,PG,25,46,1581,291,752,0.387,118,354,0.333,173,398,0.435,0.465,185,243,0.761,32,143,175,362,81,14,131,126,885,OOR,2005
Dale Davis,C,35,61,1307,112,234,0.479,0,0,0.0,112,234,0.479,0.479,60,99,0.606,152,223,375,47,32,65,43,162,284,OOR,2005
Josh Davis,PF,24,42,328,42,111,0.378,19,53,0.358,23,58,0.397,0.464,14,17,0.824,29,50,79,12,8,4,15,45,117,OOR,2005
Ricky Davis,SG,25,82,2696,481,1041,0.462,61,180,0.339,420,861,0.488,0.491,286,351,0.815,66,183,249,246,89,27,205,174,1309,OOR,2005
Andrew DeClercq,C,31,8,49,4,9,0.444,0,0,0.0,4,9,0.444,0.444,1,3,0.333,7,3,10,0,2,0,1,14,9,OOR,2005
Carlos Delfino,SG,22,30,459,42,117,0.359,9,35,0.257,33,82,0.402,0.397,23,40,0.575,13,42,55,38,22,6,23,44,116,OOR,2005
Tony Delk,SG,31,56,1340,246,591,0.416,72,202,0.356,174,389,0.447,0.477,103,136,0.757,28,102,130,104,47,3,54,123,667,OOR,2005
Luol Deng,SF,19,61,1663,280,645,0.434,31,117,0.265,249,528,0.472,0.458,120,162,0.741,92,230,322,135,48,27,118,98,711,OOR,2005
Boris Diaw,SG,22,66,1201,124,294,0.422,9,50,0.18,115,244,0.471,0.437,57,77,0.74,54,116,170,149,37,18,87,123,314,OOR,2005
Dan Dickau,PG,26,71,2090,306,756,0.405,85,245,0.347,221,511,0.432,0.461,190,228,0.833,34,146,180,347,76,4,145,201,887,OOR,2005
Kaniel Dickens,SF,26,11,61,4,14,0.286,3,9,0.333,1,5,0.2,0.393,2,2,1.0,3,6,9,1,2,1,2,5,13,OOR,2005
DeSagana Diop,C,23,39,306,20,69,0.29,0,2,0.0,20,67,0.299,0.29,0,5,0.0,30,40,70,15,8,27,12,53,40,OOR,2005
Vlade Divac,C,36,15,130,13,31,0.419,0,0,0.0,13,31,0.419,0.419,8,12,0.667,18,14,32,19,4,1,14,25,34,OOR,2005
Juan Dixon,SG,26,63,1054,186,447,0.416,48,147,0.327,138,300,0.46,0.47,87,97,0.897,32,87,119,111,43,4,68,98,507,OOR,2005
Michael Doleac,C,27,80,1175,148,331,0.447,0,2,0.0,148,329,0.45,0.447,25,41,0.61,74,185,259,47,23,22,36,160,321,OOR,2005
Keyon Dooling,PG,24,74,1184,139,345,0.403,19,75,0.253,120,270,0.444,0.43,85,109,0.78,11,79,90,132,39,11,65,120,382,OOR,2005
Predrag Drobnjak,C,29,71,1435,238,543,0.438,25,71,0.352,213,472,0.451,0.461,96,120,0.8,73,165,238,49,42,24,78,138,597,OOR,2005
Chris Duhon,PG,22,82,2177,172,488,0.352,94,265,0.355,78,223,0.35,0.449,49,67,0.731,23,190,213,398,82,3,119,205,487,OOR,2005
Tim Duncan,PF,28,66,2203,517,1042,0.496,3,9,0.333,514,1033,0.498,0.498,305,455,0.67,202,530,732,179,45,174,127,144,1342,Candidate,2005
Mike Dunleavy,SF,24,79,2570,408,905,0.451,107,276,0.388,301,629,0.479,0.51,134,172,0.779,97,338,435,203,79,26,132,198,1057,OOR,2005
Ronald Dupree,SF,24,47,472,61,127,0.48,1,2,0.5,60,125,0.48,0.484,29,47,0.617,34,61,95,24,7,10,22,60,152,OOR,2005
Ndudi Ebi,SG,20,2,54,11,21,0.524,0,1,0.0,11,20,0.55,0.524,5,9,0.556,6,10,16,1,1,1,3,7,27,OOR,2005
Corsley Edwards,C,25,10,110,10,31,0.323,0,0,0.0,10,31,0.323,0.323,7,12,0.583,12,13,25,3,3,4,2,19,27,OOR,2005
John Edwards,C,23,25,139,11,30,0.367,0,0,0.0,11,30,0.367,0.367,7,14,0.5,8,11,19,3,3,4,8,12,29,OOR,2005
Howard Eisley,PG,32,74,1428,161,405,0.398,27,103,0.262,134,302,0.444,0.431,66,83,0.795,15,75,90,250,45,9,111,156,415,OOR,2005
Obinna Ekezie,C,29,42,732,79,182,0.434,0,1,0.0,79,181,0.436,0.434,72,93,0.774,69,110,179,11,22,12,45,129,230,OOR,2005
Francisco Elson,C,28,67,939,101,216,0.468,1,3,0.333,100,213,0.469,0.47,45,79,0.57,61,140,201,34,34,41,40,129,248,OOR,2005
Melvin Ely,PF,26,79,1649,227,526,0.432,0,0,0.0,227,526,0.432,0.432,122,212,0.575,142,184,326,76,32,69,115,199,576,OOR,2005
Andre Emmett,SG,22,8,28,2,6,0.333,0,0,0.0,2,6,0.333,0.333,3,5,0.6,0,2,2,0,0,0,1,4,7,OOR,2005
Maurice Evans,SG,26,65,1233,165,373,0.442,27,82,0.329,138,291,0.474,0.479,59,78,0.756,88,113,201,45,37,8,34,104,416,OOR,2005
Reggie Evans,PF,24,79,1881,131,275,0.476,0,2,0.0,131,273,0.48,0.476,125,234,0.534,254,482,736,58,58,15,104,202,387,OOR,2005
Michael Finley,SG,31,64,2358,387,907,0.427,116,285,0.407,271,622,0.436,0.491,113,136,0.831,45,217,262,169,48,18,60,123,1003,OOR,2005
Derek Fisher,PG,30,74,2222,297,755,0.393,108,291,0.371,189,464,0.407,0.465,175,203,0.862,38,180,218,301,76,4,129,176,877,OOR,2005
Marcus Fizer,PF,26,54,903,133,292,0.455,0,6,0.0,133,286,0.465,0.455,70,103,0.68,29,146,175,64,25,13,63,96,336,OOR,2005
Luis Flores,PG,23,16,77,14,29,0.483,5,10,0.5,9,19,0.474,0.569,2,2,1.0,1,2,3,11,2,0,11,9,35,OOR,2005
Danny Fortson,C,28,62,1047,118,226,0.522,0,0,0.0,118,226,0.522,0.522,227,258,0.88,157,191,348,8,15,7,91,265,463,OOR,2005
Jeff Foster,C,28,61,1594,168,324,0.519,0,5,0.0,168,319,0.527,0.519,90,142,0.634,205,345,550,43,46,12,55,186,426,OOR,2005
Tremaine Fowlkes,SF,28,8,56,9,17,0.529,1,3,0.333,8,14,0.571,0.559,0,2,0.0,3,5,8,0,2,0,5,7,19,OOR,2005
Adonal Foyle,C,29,78,1700,156,311,0.502,0,0,0.0,156,311,0.502,0.502,40,72,0.556,165,264,429,56,26,159,58,201,352,OOR,2005
Richie Frahm,SG,27,43,499,56,140,0.4,31,80,0.388,25,60,0.417,0.511,21,25,0.84,17,44,61,30,15,4,14,35,164,OOR,2005
Steve Francis,PG,27,78,2978,563,1330,0.423,38,127,0.299,525,1203,0.436,0.438,499,606,0.823,126,324,450,547,112,28,317,273,1663,OOR,2005
Matt Freije,PF,23,23,441,37,127,0.291,14,54,0.259,23,73,0.315,0.346,5,8,0.625,16,45,61,20,13,2,17,40,93,OOR,2005
Lawrence Funderburke,PF,34,2,21,3,6,0.5,0,0,0.0,3,6,0.5,0.5,3,5,0.6,1,2,3,0,0,0,0,2,9,OOR,2005
Dan Gadzuric,C,26,81,1783,243,451,0.539,0,0,0.0,243,451,0.539,0.539,107,199,0.538,261,413,674,30,47,106,81,224,593,OOR,2005
Reece Gaines,PG,24,21,187,17,50,0.34,4,14,0.286,13,36,0.361,0.38,3,4,0.75,1,13,14,7,5,1,7,17,41,OOR,2005
Alex Garcia,SG,24,8,146,18,52,0.346,5,18,0.278,13,34,0.382,0.394,3,4,0.75,7,8,15,18,4,1,8,15,44,OOR,2005
Kevin Garnett,PF,28,82,3121,683,1360,0.502,6,25,0.24,677,1335,0.507,0.504,445,549,0.811,247,861,1108,466,121,112,222,207,1817,OOR,2005
Pat Garrity,PF,28,71,955,123,306,0.402,49,147,0.333,74,159,0.465,0.482,29,33,0.879,21,103,124,30,19,9,30,107,324,OOR,2005
Pau Gasol,PF,24,56,1790,357,695,0.514,1,6,0.167,356,689,0.517,0.514,282,367,0.768,130,280,410,135,37,93,137,146,997,OOR,2005
Devean George,SF,27,15,306,37,104,0.356,21,58,0.362,16,46,0.348,0.457,15,20,0.75,13,40,53,14,8,2,12,32,110,OOR,2005
Eddie Gill,PG,26,73,1021,81,242,0.335,36,117,0.308,45,125,0.36,0.409,71,81,0.877,16,96,112,83,59,5,60,105,269,OOR,2005
Kendall Gill,SG,36,14,284,32,80,0.4,3,9,0.333,29,71,0.408,0.419,18,20,0.9,11,26,37,27,14,4,9,37,85,OOR,2005
Manu Ginóbili,SG,27,74,2193,367,780,0.471,97,258,0.376,270,522,0.517,0.533,355,442,0.803,75,254,329,288,119,27,172,190,1186,OOR,2005
Gordan Giriček,SG,27,81,1660,283,632,0.448,38,105,0.362,245,527,0.465,0.478,111,137,0.81,25,157,182,137,46,11,90,155,715,OOR,2005
Dion Glover,SG,26,7,68,8,22,0.364,1,8,0.125,7,14,0.5,0.386,8,10,0.8,3,8,11,4,3,3,2,9,25,OOR,2005
Anthony Goldwire,PG,33,33,537,57,136,0.419,32,80,0.4,25,56,0.446,0.537,26,31,0.839,10,49,59,78,15,0,15,32,172,OOR,2005
Drew Gooden,PF,23,82,2523,464,943,0.492,5,28,0.179,459,915,0.502,0.495,251,310,0.81,207,546,753,130,77,76,133,233,1184,OOR,2005
Ben Gordon,SG,21,82,2002,434,1056,0.411,134,331,0.405,300,725,0.414,0.474,233,270,0.863,55,160,215,164,53,10,186,224,1235,OOR,2005
Brian Grant,C,32,69,1136,103,209,0.493,0,0,0.0,103,209,0.493,0.493,57,79,0.722,101,156,257,34,23,23,43,175,263,OOR,2005
Willie Green,SG,23,57,1066,155,423,0.366,30,105,0.286,125,318,0.393,0.402,97,125,0.776,22,111,133,100,34,6,75,121,437,OOR,2005
Adrian Griffin,SF,30,69,667,58,161,0.36,2,9,0.222,56,152,0.368,0.366,33,44,0.75,52,94,146,53,43,4,30,78,151,OOR,2005
Eddie Griffin,PF,22,70,1492,202,522,0.387,67,204,0.328,135,318,0.425,0.451,56,78,0.718,128,325,453,53,23,118,55,120,527,OOR,2005
Tom Gugliotta,PF,35,47,966,99,241,0.411,8,26,0.308,91,215,0.423,0.427,33,43,0.767,56,135,191,68,41,17,57,104,239,OOR,2005
Marcus Haislip,PF,24,9,106,13,38,0.342,0,1,0.0,13,37,0.351,0.342,6,11,0.545,5,10,15,3,2,2,6,15,32,OOR,2005
Darvin Ham,SF,31,47,275,17,37,0.459,0,0,0.0,17,37,0.459,0.459,12,31,0.387,19,16,35,5,6,7,8,39,46,OOR,2005
Richard Hamilton,SG,26,76,2926,510,1160,0.44,36,118,0.305,474,1042,0.455,0.455,368,429,0.858,74,221,295,372,77,13,217,232,1424,OOR,2005
Zendon Hamilton,C,29,16,159,11,32,0.344,0,0,0.0,11,32,0.344,0.344,29,48,0.604,18,24,42,6,5,2,12,26,51,OOR,2005
Ben Handlogten,C,31,21,297,43,83,0.518,0,1,0.0,43,82,0.524,0.518,9,17,0.529,23,42,65,13,7,5,18,55,95,OOR,2005
Anfernee Hardaway,SF,33,37,894,110,260,0.423,15,50,0.3,95,210,0.452,0.452,34,46,0.739,19,70,89,74,28,3,50,79,269,OOR,2005
Matt Harpring,SF,28,78,2584,418,855,0.489,9,43,0.209,409,812,0.504,0.494,245,315,0.778,196,284,480,142,70,16,133,250,1090,OOR,2005
Al Harrington,SF,24,66,2550,453,986,0.459,16,74,0.216,437,912,0.479,0.468,236,351,0.672,145,316,461,208,85,16,204,249,1158,OOR,2005
Junior Harrington,SG,24,29,550,64,178,0.36,6,19,0.316,58,159,0.365,0.376,29,35,0.829,13,50,63,62,25,5,41,72,163,OOR,2005
Othella Harrington,PF,31,70,1271,217,424,0.512,0,0,0.0,217,424,0.512,0.512,127,177,0.718,106,186,292,56,24,18,84,188,561,OOR,2005
Devin Harris,PG,21,76,1173,157,366,0.429,44,131,0.336,113,235,0.481,0.489,78,103,0.757,28,74,102,169,77,19,82,139,436,OOR,2005
Lucious Harris,SG,34,73,1128,118,299,0.395,21,65,0.323,97,234,0.415,0.43,56,69,0.812,39,82,121,49,27,6,29,68,313,OOR,2005
David Harrison,C,22,43,760,106,184,0.576,0,0,0.0,106,184,0.576,0.576,52,91,0.571,48,87,135,13,16,55,53,134,264,OOR,2005
Jason Hart,PG,26,74,1887,257,573,0.449,35,95,0.368,222,478,0.464,0.479,157,200,0.785,18,185,203,367,99,14,102,167,706,OOR,2005
Donnell Harvey,PF,24,3,16,2,2,1.0,0,0,0.0,2,2,1.0,1.0,4,4,1.0,2,5,7,1,1,1,1,2,8,OOR,2005
Udonis Haslem,PF,24,80,2675,346,641,0.54,0,4,0.0,346,637,0.543,0.54,178,225,0.791,239,487,726,108,63,41,113,260,870,OOR,2005
Trenton Hassell,SG,25,82,2068,225,475,0.474,1,11,0.091,224,464,0.483,0.475,90,114,0.789,80,139,219,128,30,30,64,200,541,OOR,2005
Jarvis Hayes,SF,23,54,1560,206,530,0.389,42,123,0.341,164,407,0.403,0.428,99,118,0.839,41,186,227,90,49,9,62,107,553,OOR,2005
Brendan Haywood,C,25,68,1865,239,427,0.56,0,0,0.0,239,427,0.56,0.56,159,261,0.609,202,262,464,57,52,114,96,218,637,OOR,2005
Alan Henderson,PF,32,78,1203,116,220,0.527,0,2,0.0,116,218,0.532,0.527,41,76,0.539,164,184,348,21,29,37,49,149,273,OOR,2005
Nenê,C,22,55,1317,194,386,0.503,0,2,0.0,194,384,0.505,0.503,140,212,0.66,104,221,325,84,50,48,94,167,528,OOR,2005
Grant Hill,SF,32,67,2338,517,1015,0.509,3,13,0.231,514,1002,0.513,0.511,280,341,0.821,77,241,318,220,97,28,161,144,1317,OOR,2005
Kirk Hinrich,PG,24,77,2800,445,1122,0.397,145,408,0.355,300,714,0.42,0.461,171,216,0.792,32,272,304,494,122,21,176,244,1206,OOR,2005
Fred Hoiberg,SG,32,76,1272,139,284,0.489,70,145,0.483,69,139,0.496,0.613,89,102,0.873,32,149,181,85,50,15,20,105,437,OOR,2005
Robert Horry,PF,34,75,1396,157,375,0.419,51,138,0.37,106,237,0.447,0.487,86,109,0.789,91,177,268,80,67,60,69,138,451,OOR,2005
Eddie House,PG-SG,26,68,891,165,366,0.451,44,97,0.454,121,269,0.45,0.511,23,27,0.852,16,67,83,96,44,6,35,65,397,OOR,2005
Allan Houston,SG,33,20,532,85,205,0.415,31,80,0.388,54,125,0.432,0.49,36,43,0.837,4,19,23,42,8,2,21,40,237,OOR,2005
Dwight Howard,PF,19,82,2670,352,677,0.52,0,2,0.0,352,675,0.521,0.52,277,413,0.671,287,536,823,75,77,136,165,232,981,OOR,2005
Josh Howard,SF,24,76,2446,377,793,0.475,34,115,0.296,343,678,0.506,0.497,170,232,0.733,169,315,484,109,116,49,122,211,958,OOR,2005
Juwan Howard,PF,31,61,1624,244,541,0.451,0,1,0.0,244,540,0.452,0.451,97,115,0.843,126,220,346,94,32,5,79,143,585,OOR,2005
Troy Hudson,PG,28,79,1729,266,664,0.401,89,258,0.345,177,406,0.436,0.468,70,90,0.778,19,86,105,283,27,6,113,121,691,OOR,2005
Larry Hughes,SG,26,61,2358,467,1086,0.43,59,209,0.282,408,877,0.465,0.457,352,453,0.777,74,308,382,285,176,18,153,168,1345,OOR,2005
Ryan Humphrey,SF,25,35,317,42,103,0.408,0,2,0.0,42,101,0.416,0.408,18,37,0.486,50,37,87,6,10,1,23,35,102,OOR,2005
Kris Humphries,PF,19,67,873,116,287,0.404,2,6,0.333,114,281,0.406,0.408,44,101,0.436,73,124,197,43,25,18,52,96,278,OOR,2005
Brandon Hunter,PF,24,31,224,37,73,0.507,0,0,0.0,37,73,0.507,0.507,21,39,0.538,25,44,69,3,4,7,22,42,95,OOR,2005
Lindsey Hunter,SG,34,76,1144,108,302,0.358,23,84,0.274,85,218,0.39,0.396,46,58,0.793,38,85,123,130,68,13,68,125,285,OOR,2005
Steven Hunter,C,23,76,1046,135,220,0.614,0,1,0.0,135,219,0.616,0.614,78,163,0.479,98,129,227,13,4,102,44,131,348,OOR,2005
Andre Iguodala,SG,21,82,2686,269,546,0.493,47,142,0.331,222,404,0.55,0.536,156,210,0.743,89,375,464,246,138,48,139,204,741,OOR,2005
Zydrunas Ilgauskas,C,29,78,2615,458,979,0.468,2,7,0.286,456,972,0.469,0.469,402,503,0.799,299,373,672,100,53,165,191,313,1320,OOR,2005
D.J. Mbenga,C,24,15,58,6,14,0.429,0,0,0.0,6,14,0.429,0.429,3,4,0.75,3,5,8,0,0,5,5,13,15,OOR,2005
Allen Iverson,PG,29,75,3174,771,1818,0.424,104,338,0.308,667,1480,0.451,0.453,656,786,0.835,51,248,299,596,180,9,344,140,2302,Candidate,2005
Royal Ivey,PG,23,62,809,85,198,0.429,3,9,0.333,82,189,0.434,0.437,47,67,0.701,19,65,84,103,39,7,58,140,220,OOR,2005
Bobby Jackson,SG,31,25,536,109,255,0.427,33,96,0.344,76,159,0.478,0.492,50,58,0.862,23,62,85,59,14,2,28,58,301,OOR,2005
Jermaine Jackson,SG,28,21,230,17,33,0.515,0,2,0.0,17,31,0.548,0.515,8,13,0.615,3,20,23,24,7,1,10,26,42,OOR,2005
Jim Jackson,SF,34,64,1987,248,582,0.426,122,295,0.414,126,287,0.439,0.531,54,58,0.931,33,236,269,183,35,5,115,153,672,OOR,2005
Luke Jackson,SF,23,10,43,10,27,0.37,4,6,0.667,6,21,0.286,0.444,5,6,0.833,2,4,6,3,0,0,2,4,29,OOR,2005
Marc Jackson,C,30,81,1976,340,731,0.465,0,2,0.0,340,729,0.466,0.465,289,349,0.828,184,222,406,81,32,18,131,171,969,OOR,2005
Stephen Jackson,SF,26,51,1806,330,819,0.403,103,286,0.36,227,533,0.426,0.466,190,229,0.83,44,206,250,119,64,14,123,154,953,OOR,2005
Casey Jacobsen,SG-SF,23,84,1798,165,408,0.404,66,177,0.373,99,231,0.429,0.485,151,192,0.786,35,132,167,113,33,8,71,104,547,OOR,2005
Jerome James,C,29,80,1330,174,342,0.509,0,2,0.0,174,340,0.512,0.509,47,65,0.723,81,160,241,19,23,111,88,279,395,OOR,2005
LeBron James,SF,20,80,3388,795,1684,0.472,108,308,0.351,687,1376,0.499,0.504,477,636,0.75,111,477,588,577,177,52,262,146,2175,OOR,2005
Mike James,PG,29,74,1859,331,751,0.441,100,259,0.386,231,492,0.47,0.507,109,145,0.752,35,173,208,263,65,6,106,174,871,OOR,2005
Antawn Jamison,PF,28,68,2605,519,1189,0.437,71,208,0.341,448,981,0.457,0.466,225,296,0.76,160,359,519,154,55,16,118,151,1334,OOR,2005
Marko Jarić,PG,26,50,1656,189,457,0.414,56,151,0.371,133,306,0.435,0.475,59,82,0.72,20,141,161,303,84,17,98,107,493,OOR,2005
Al Jefferson,PF,20,71,1051,195,369,0.528,0,3,0.0,195,366,0.533,0.528,85,135,0.63,119,193,312,24,22,55,66,195,475,OOR,2005
Richard Jefferson,SF,24,33,1355,238,564,0.422,30,89,0.337,208,475,0.438,0.449,227,269,0.844,49,191,240,133,33,17,132,109,733,OOR,2005
Jared Jeffries,SF,23,77,2007,203,434,0.468,16,51,0.314,187,383,0.488,0.486,101,173,0.584,152,222,374,151,66,35,114,206,523,OOR,2005
Horace Jenkins,PG,30,15,104,15,45,0.333,0,9,0.0,15,36,0.417,0.333,12,13,0.923,3,6,9,9,5,1,7,6,42,OOR,2005
Britton Johnsen,SF,25,6,87,6,22,0.273,0,4,0.0,6,18,0.333,0.273,0,0,0.0,5,5,10,4,1,0,3,10,12,OOR,2005
Anthony Johnson,PG,30,63,1747,203,456,0.445,41,108,0.38,162,348,0.466,0.49,85,113,0.752,32,147,179,302,59,15,96,144,532,OOR,2005
DerMarr Johnson,SG,24,71,1232,185,371,0.499,53,148,0.358,132,223,0.592,0.57,80,101,0.792,43,108,151,75,43,18,65,140,503,OOR,2005
Ervin Johnson,C,37,46,410,28,54,0.519,1,1,1.0,27,53,0.509,0.528,16,25,0.64,43,70,113,6,7,13,18,86,73,OOR,2005
Joe Johnson,SF,23,82,3240,544,1179,0.461,177,370,0.478,367,809,0.454,0.536,135,180,0.75,120,302,422,291,79,24,148,167,1400,OOR,2005
Linton Johnson,SF,24,2,15,0,2,0.0,0,1,0.0,0,1,0.0,0.0,0,0,0.0,0,3,3,0,1,0,1,1,0,OOR,2005
Dahntay Jones,SG,24,52,649,83,190,0.437,23,60,0.383,60,130,0.462,0.497,44,64,0.688,11,58,69,21,13,11,29,81,233,OOR,2005
Damon Jones,PG,28,82,2576,331,726,0.456,225,521,0.432,106,205,0.517,0.611,68,86,0.791,14,217,231,350,44,5,98,121,955,OOR,2005
Eddie Jones,SF,33,80,2839,351,820,0.428,142,382,0.372,209,438,0.477,0.515,174,216,0.806,38,367,405,212,86,38,99,251,1018,OOR,2005
Fred Jones,SG,25,77,2268,275,647,0.425,87,229,0.38,188,418,0.45,0.492,176,207,0.85,34,208,242,196,61,31,114,171,813,OOR,2005
James Jones,SF,24,75,1330,126,318,0.396,66,166,0.398,60,152,0.395,0.5,53,62,0.855,39,135,174,57,31,28,43,123,371,OOR,2005
Jumaine Jones,SF,25,76,1830,210,486,0.432,102,261,0.391,108,225,0.48,0.537,55,75,0.733,107,291,398,65,44,24,49,165,577,OOR,2005
Mark Jones,SF,29,10,116,9,31,0.29,0,4,0.0,9,27,0.333,0.29,5,10,0.5,6,7,13,6,5,2,3,16,23,OOR,2005
Chris Kaman,C,22,63,1632,246,495,0.497,0,1,0.0,246,494,0.498,0.497,80,121,0.661,135,288,423,73,26,68,115,182,572,OOR,2005
Jason Kapono,SF,23,81,1491,269,671,0.401,80,194,0.412,189,477,0.396,0.461,70,85,0.824,32,132,164,61,40,6,46,132,688,OOR,2005
Mario Kasun,C,24,45,356,47,98,0.48,0,1,0.0,47,97,0.485,0.48,24,43,0.558,52,76,128,8,8,13,26,86,118,OOR,2005
Viktor Khryapa,SF,22,32,523,54,124,0.435,4,11,0.364,50,113,0.442,0.452,23,42,0.548,28,80,108,25,20,18,33,80,135,OOR,2005
Jason Kidd,PG,31,66,2435,340,855,0.398,129,358,0.36,211,497,0.425,0.473,142,192,0.74,94,394,488,545,123,9,167,110,951,OOR,2005
Andrei Kirilenko,PF,23,41,1349,207,420,0.493,23,77,0.299,184,343,0.536,0.52,203,259,0.784,89,166,255,132,67,136,90,101,640,OOR,2005
Kerry Kittles,SG,30,11,243,28,73,0.384,7,21,0.333,21,52,0.404,0.432,6,10,0.6,1,31,32,20,8,3,7,12,69,OOR,2005
Brandin Knight,PG,23,1,3,0,1,0.0,0,0,0.0,0,1,0.0,0.0,0,0,0.0,0,0,0,1,0,0,0,0,0,OOR,2005
Brevin Knight,PG,29,66,1944,248,587,0.422,3,20,0.15,245,567,0.432,0.425,167,196,0.852,21,149,170,591,131,5,147,192,666,OOR,2005
Kyle Korver,SF,23,82,2667,317,759,0.418,226,558,0.405,91,201,0.453,0.567,82,96,0.854,40,339,379,182,103,33,106,265,942,OOR,2005
Nenad Krstić,PF,21,75,1965,281,570,0.493,0,2,0.0,281,568,0.495,0.493,185,255,0.725,161,240,401,77,32,63,112,280,747,OOR,2005
Toni Kukoč,SF,36,53,1099,105,256,0.41,42,116,0.362,63,140,0.45,0.492,44,61,0.721,31,129,160,160,39,13,64,70,296,OOR,2005
Ibo Kutluay,SG,30,5,12,0,1,0.0,0,0,0.0,0,1,0.0,0.0,0,0,0.0,0,1,1,0,0,0,2,1,0,OOR,2005
Christian Laettner,PF,35,49,739,107,184,0.582,1,7,0.143,106,177,0.599,0.584,45,59,0.763,36,95,131,41,32,15,29,78,260,OOR,2005
Raef LaFrentz,PF,28,80,2196,341,688,0.496,82,225,0.364,259,463,0.559,0.555,120,148,0.811,154,399,553,98,42,99,70,262,884,OOR,2005
Maciej Lampe,C,19,37,380,49,132,0.371,2,4,0.5,47,128,0.367,0.379,15,22,0.682,24,65,89,11,5,7,17,51,115,OOR,2005
Voshon Lenard,SG,31,3,54,10,26,0.385,4,12,0.333,6,14,0.429,0.462,5,8,0.625,0,6,6,6,1,0,2,2,29,OOR,2005
Rashard Lewis,SF,25,71,2697,532,1151,0.462,173,432,0.4,359,719,0.499,0.537,220,283,0.777,110,278,388,94,75,62,123,158,1457,OOR,2005
Randy Livingston,PG,29,17,227,22,52,0.423,5,8,0.625,17,44,0.386,0.471,15,17,0.882,3,9,12,45,12,2,14,28,64,OOR,2005
Shaun Livingston,PG,19,30,814,89,215,0.414,0,2,0.0,89,213,0.418,0.414,44,59,0.746,22,67,89,151,32,11,75,82,222,OOR,2005
Raül López,PG,24,31,518,57,135,0.422,20,45,0.444,37,90,0.411,0.496,27,33,0.818,7,32,39,123,22,3,47,78,161,OOR,2005
Tyronn Lue,PG,27,70,2007,295,654,0.451,55,155,0.355,240,499,0.481,0.493,142,165,0.861,14,135,149,322,33,0,105,168,787,OOR,2005
George Lynch,SF,34,44,933,68,189,0.36,11,37,0.297,57,152,0.375,0.389,17,23,0.739,55,119,174,88,32,12,57,83,164,OOR,2005
Mark Madsen,C,29,41,601,34,66,0.515,0,0,0.0,34,66,0.515,0.515,20,40,0.5,63,65,128,18,7,14,24,103,88,OOR,2005
Corey Maggette,SG,25,66,2436,425,986,0.431,51,168,0.304,374,818,0.457,0.457,563,657,0.857,70,324,394,225,70,8,195,191,1464,OOR,2005
Jamaal Magloire,C,26,23,703,98,227,0.432,0,0,0.0,98,227,0.432,0.432,74,123,0.602,79,126,205,29,8,23,59,74,270,OOR,2005
Stephon Marbury,PG,27,82,3281,604,1308,0.462,115,325,0.354,489,983,0.497,0.506,458,549,0.834,50,198,248,668,122,6,233,186,1781,OOR,2005
Shawn Marion,PF,26,81,3146,613,1289,0.476,114,341,0.334,499,948,0.526,0.52,229,275,0.833,235,680,915,154,163,119,125,199,1569,OOR,2005
Sean Marks,PF,29,23,244,27,80,0.338,0,3,0.0,27,77,0.351,0.338,22,28,0.786,18,38,56,8,3,11,14,29,76,OOR,2005
Donyell Marshall,PF,31,65,1645,262,592,0.443,151,363,0.416,111,229,0.485,0.57,72,91,0.791,95,333,428,81,57,46,42,136,747,OOR,2005
Darrick Martin,PG,33,11,190,16,50,0.32,5,18,0.278,11,32,0.344,0.37,5,8,0.625,3,7,10,28,6,0,6,19,42,OOR,2005
Kenyon Martin,PF,27,70,2272,444,907,0.49,0,12,0.0,444,895,0.496,0.49,199,308,0.646,146,365,511,170,100,78,149,228,1087,OOR,2005
Kevin Martin,PG,21,45,455,45,117,0.385,5,25,0.2,40,92,0.435,0.406,36,55,0.655,29,29,58,22,16,3,24,35,131,OOR,2005
Desmond Mason,SF,27,80,2893,478,1079,0.443,1,8,0.125,477,1071,0.445,0.443,420,524,0.802,85,227,312,217,58,27,164,198,1377,OOR,2005
Tony Massenburg,PF,37,61,699,74,182,0.407,0,0,0.0,74,182,0.407,0.407,48,63,0.762,54,109,163,14,18,20,40,122,196,OOR,2005
Walter McCarty,PF,30,72,906,95,235,0.404,55,155,0.355,40,80,0.5,0.521,15,29,0.517,29,109,138,37,25,15,36,144,260,OOR,2005
Jelani McCoy,C,27,10,88,7,13,0.538,0,0,0.0,7,13,0.538,0.538,1,5,0.2,7,14,21,0,3,8,6,24,15,OOR,2005
Antonio McDyess,PF,30,77,1797,307,598,0.513,0,1,0.0,307,597,0.514,0.513,126,192,0.656,177,305,482,71,46,52,93,204,740,OOR,2005
Tracy McGrady,SF,25,78,3182,715,1660,0.431,142,435,0.326,573,1225,0.468,0.473,431,557,0.774,71,413,484,448,135,52,201,167,2003,OOR,2005
Jeff McInnis,PG,30,76,2651,377,915,0.412,91,264,0.345,286,651,0.439,0.462,130,160,0.813,32,125,157,391,56,1,117,177,975,OOR,2005
Aaron McKie,SG,32,68,1118,61,142,0.43,20,62,0.323,41,80,0.513,0.5,10,16,0.625,20,152,172,103,48,17,31,116,152,OOR,2005
Keith McLeod,PG,25,53,1382,143,408,0.35,18,72,0.25,125,336,0.372,0.373,112,146,0.767,20,93,113,236,63,12,99,138,416,OOR,2005
Stanislav Medvedenko,PF,25,43,423,71,156,0.455,0,1,0.0,71,155,0.458,0.455,23,28,0.821,31,48,79,13,9,2,13,64,165,OOR,2005
Ron Mercer,SF,28,18,390,65,158,0.411,0,3,0.0,65,155,0.419,0.411,7,10,0.7,9,31,40,20,16,2,14,20,137,OOR,2005
Chris Mihm,C,25,75,1870,280,552,0.507,0,2,0.0,280,550,0.509,0.507,175,258,0.678,197,305,502,50,14,108,110,237,735,OOR,2005
Darius Miles,SF,23,63,1699,336,697,0.482,8,23,0.348,328,674,0.487,0.488,129,215,0.6,71,228,299,129,75,78,157,189,809,OOR,2005
Darko Miličić,C,19,37,254,25,76,0.329,0,0,0.0,25,76,0.329,0.329,17,24,0.708,3,40,43,7,2,17,16,31,67,OOR,2005
Andre Miller,PG,28,82,2852,427,895,0.477,6,39,0.154,421,856,0.492,0.48,253,302,0.838,100,238,338,569,121,8,220,204,1113,OOR,2005
Anthony Miller,PF,33,2,9,2,3,0.667,0,0,0.0,2,3,0.667,0.667,0,0,0.0,0,1,1,1,1,0,1,2,4,OOR,2005
Brad Miller,C,28,56,2089,319,609,0.524,5,19,0.263,314,590,0.532,0.528,233,287,0.812,139,382,521,220,69,68,82,181,876,OOR,2005
Mike Miller,SF,24,76,2278,387,766,0.505,140,323,0.433,247,443,0.558,0.597,108,150,0.72,36,264,300,220,54,23,127,197,1022,OOR,2005
Reggie Miller,SG,39,66,2105,314,719,0.437,96,298,0.322,218,421,0.518,0.503,250,268,0.933,18,138,156,146,50,5,77,109,974,OOR,2005
Yao Ming,C,24,80,2447,538,975,0.552,0,0,0.0,538,975,0.552,0.552,389,497,0.783,208,461,669,61,34,160,196,298,1465,OOR,2005
Cuttino Mobley,SG,29,66,2388,408,932,0.438,150,342,0.439,258,590,0.437,0.518,168,205,0.82,45,184,229,188,74,30,133,152,1134,OOR,2005
Nazr Mohammed,C,27,77,1933,289,602,0.48,0,1,0.0,289,601,0.481,0.48,153,227,0.674,247,339,586,34,58,86,108,236,731,OOR,2005
Jérôme Moïso,C-PF,26,20,120,9,18,0.5,0,1,0.0,9,17,0.529,0.5,10,13,0.769,10,27,37,1,3,6,7,13,28,OOR,2005
Mikki Moore,PF,29,74,1178,144,287,0.502,1,5,0.2,143,282,0.507,0.503,107,136,0.787,97,149,246,47,19,32,63,173,396,OOR,2005
Alonzo Mourning,C-PF,34,37,702,100,212,0.472,0,0,0.0,100,212,0.472,0.472,82,141,0.582,53,145,198,18,8,74,57,82,282,OOR,2005
Troy Murphy,PF,24,70,2375,392,947,0.414,59,148,0.399,333,799,0.417,0.445,233,319,0.73,251,505,756,97,53,33,108,190,1076,OOR,2005
Lamond Murray,SF,31,62,918,132,310,0.426,46,105,0.438,86,205,0.42,0.5,61,80,0.763,44,120,164,47,32,16,54,85,371,OOR,2005
Ronald Murray,SG,25,49,883,131,363,0.361,24,95,0.253,107,268,0.399,0.394,59,80,0.738,15,83,98,65,30,11,57,59,345,OOR,2005
Dikembe Mutombo,C,38,80,1212,108,217,0.498,0,0,0.0,108,217,0.498,0.498,106,143,0.741,150,276,426,10,16,101,51,135,322,OOR,2005
Mamadou N'Diaye,C,29,11,72,8,20,0.4,0,1,0.0,8,19,0.421,0.4,4,7,0.571,9,9,18,1,1,5,0,20,20,OOR,2005
Boštjan Nachbar,PF-SF,24,71,1341,161,411,0.392,75,196,0.383,86,215,0.4,0.483,97,117,0.829,24,158,182,74,29,16,73,183,494,OOR,2005
Lee Nailon,SF,29,68,2017,415,869,0.478,0,2,0.0,415,867,0.479,0.478,133,165,0.806,128,170,298,109,36,16,110,190,963,OOR,2005
Eduardo Nájera,PF,28,68,1185,145,322,0.45,6,21,0.286,139,301,0.462,0.46,58,91,0.637,102,141,243,65,41,24,61,148,354,OOR,2005
Steve Nash,PG,30,75,2573,430,857,0.502,94,218,0.431,336,639,0.526,0.557,211,238,0.887,57,192,249,861,74,6,245,136,1165,MVP,2005
Jameer Nelson,PG,22,79,1612,286,628,0.455,44,141,0.312,242,487,0.497,0.49,73,107,0.682,52,141,193,237,78,3,117,199,689,OOR,2005
Rasho Nesterović,C,28,70,1785,198,430,0.46,0,0,0.0,198,430,0.46,0.46,14,30,0.467,184,275,459,71,31,117,73,207,410,OOR,2005
Ira Newble,SG,30,74,1832,182,424,0.429,19,53,0.358,163,371,0.439,0.452,55,69,0.797,78,142,220,91,50,18,61,144,438,OOR,2005
Andrés Nocioni,SF,25,81,1892,241,601,0.401,25,97,0.258,216,504,0.429,0.422,170,222,0.766,69,317,386,122,37,34,135,208,677,OOR,2005
Moochie Norris,PG,31,38,360,35,109,0.321,0,12,0.0,35,97,0.361,0.321,20,24,0.833,10,36,46,39,18,2,27,44,90,OOR,2005
Dirk Nowitzki,PF,26,78,3020,663,1445,0.459,91,228,0.399,572,1217,0.47,0.49,615,708,0.869,96,661,757,240,97,119,176,219,2032,Candidate,2005
Jermaine O'Neal,PF,26,44,1530,386,854,0.452,1,6,0.167,385,848,0.454,0.453,295,391,0.754,85,303,388,82,25,88,131,173,1068,OOR,2005
Shaquille O'Neal,C,32,73,2492,658,1095,0.601,0,0,0.0,658,1095,0.601,0.601,353,765,0.461,253,507,760,200,36,171,203,262,1669,Candidate,2005
Lamar Odom,PF,25,64,2320,366,774,0.473,36,117,0.308,330,657,0.502,0.496,207,298,0.695,134,519,653,238,42,65,161,211,975,OOR,2005
Emeka Okafor,PF,22,73,2600,448,1003,0.447,0,1,0.0,448,1002,0.447,0.447,209,343,0.609,275,520,795,64,62,125,125,214,1105,OOR,2005
Mehmet Okur,C,25,82,2304,354,756,0.468,17,63,0.27,337,693,0.486,0.479,329,387,0.85,194,422,616,166,32,68,141,227,1054,OOR,2005
Kevin Ollie,PG,32,26,158,11,31,0.355,0,0,0.0,11,31,0.355,0.355,6,9,0.667,3,16,19,19,5,0,6,16,28,OOR,2005
Michael Olowokandi,C,29,62,1215,161,353,0.456,0,0,0.0,161,353,0.456,0.456,46,69,0.667,106,218,324,29,15,56,68,193,368,OOR,2005
Greg Ostertag,C,31,56,556,37,84,0.44,0,2,0.0,37,82,0.451,0.44,13,38,0.342,55,112,167,37,7,40,24,88,87,OOR,2005
Bo Outlaw,PF,33,39,214,12,34,0.353,0,0,0.0,12,34,0.353,0.353,5,9,0.556,16,37,53,13,6,12,8,29,29,OOR,2005
Travis Outlaw,SF,20,59,793,133,267,0.498,4,10,0.4,129,257,0.502,0.506,49,75,0.653,40,81,121,35,30,40,39,77,319,OOR,2005
Zaza Pachulia,C,20,74,1397,160,354,0.452,0,1,0.0,160,353,0.453,0.452,138,185,0.746,131,247,378,60,44,34,70,166,458,OOR,2005
Scott Padgett,PF,28,66,942,98,233,0.421,50,126,0.397,48,107,0.449,0.528,29,40,0.725,47,138,185,55,33,10,30,119,275,OOR,2005
Milt Palacio,PG,26,80,1533,175,392,0.446,2,12,0.167,173,380,0.455,0.449,115,155,0.742,26,108,134,279,48,13,104,126,467,OOR,2005
Jannero Pargo,PG,25,32,453,82,213,0.385,23,66,0.348,59,147,0.401,0.439,17,23,0.739,12,35,47,76,16,1,45,53,204,OOR,2005
Smush Parker,PG,23,16,144,18,43,0.419,3,13,0.231,15,30,0.5,0.453,9,13,0.692,4,8,12,15,5,0,19,16,48,OOR,2005
Tony Parker,PG,22,80,2735,539,1118,0.482,43,156,0.276,496,962,0.516,0.501,210,323,0.65,47,251,298,491,98,4,215,167,1331,OOR,2005
Ruben Patterson,SF,29,70,1957,319,601,0.531,2,25,0.08,317,576,0.55,0.532,169,282,0.599,126,147,273,138,106,21,143,164,809,OOR,2005
Sasha Pavlović,SG,21,65,862,120,276,0.435,30,78,0.385,90,198,0.455,0.489,44,64,0.688,15,56,71,49,29,4,47,121,314,OOR,2005
Gary Payton,PG,36,77,2541,339,725,0.468,42,129,0.326,297,596,0.498,0.497,153,201,0.761,48,188,236,469,88,12,148,121,873,OOR,2005
Anthony Peeler,SG,35,40,529,56,150,0.373,25,65,0.385,31,85,0.365,0.457,16,18,0.889,14,51,65,57,18,2,28,39,153,OOR,2005
Kirk Penney,SG,24,4,12,1,3,0.333,0,1,0.0,1,2,0.5,0.333,0,0,0.0,0,1,1,1,0,0,2,0,2,OOR,2005
Kendrick Perkins,C,20,60,548,56,119,0.471,0,0,0.0,56,119,0.471,0.471,37,58,0.638,53,123,176,21,9,37,43,98,149,OOR,2005
Wesley Person,SF,33,41,667,107,226,0.473,41,89,0.461,66,137,0.482,0.564,9,13,0.692,3,80,83,39,19,4,17,30,264,OOR,2005
Morris Peterson,SG,27,82,2510,356,848,0.42,129,335,0.385,227,513,0.442,0.496,188,226,0.832,71,269,340,169,91,18,93,219,1029,OOR,2005
Eric Piatkowski,SG,34,68,841,111,258,0.43,57,134,0.425,54,124,0.435,0.541,45,56,0.804,15,64,79,51,29,1,37,67,324,OOR,2005
Paul Pierce,SF,27,82,2960,556,1223,0.455,108,292,0.37,448,931,0.481,0.499,549,668,0.822,78,461,539,348,133,39,230,255,1769,OOR,2005
Mickaël Piétrus,SF,22,67,1340,214,501,0.427,67,195,0.344,147,306,0.48,0.494,141,202,0.698,65,124,189,82,46,18,92,139,636,OOR,2005
Zoran Planinić,PG,22,43,515,78,174,0.448,15,40,0.375,63,134,0.47,0.491,46,66,0.697,19,50,69,44,25,0,41,76,217,OOR,2005
Pavel Podkolzin,C,20,5,10,0,0,0.0,0,0,0.0,0,0,0.0,0.0,1,2,0.5,0,2,2,0,0,0,2,4,1,OOR,2005
Scot Pollard,C,29,49,865,79,167,0.473,0,0,0.0,79,167,0.473,0.473,33,49,0.673,85,120,205,18,30,24,31,123,191,OOR,2005
Mark Pope,PF,32,9,27,2,6,0.333,0,0,0.0,2,6,0.333,0.333,0,0,0.0,5,3,8,1,1,2,1,5,4,OOR,2005
James Posey,SF,28,50,1382,127,356,0.357,55,178,0.309,72,178,0.404,0.434,96,111,0.865,45,174,219,88,48,23,69,134,405,OOR,2005
Vitaly Potapenko,C,29,33,335,45,87,0.517,0,1,0.0,45,86,0.523,0.517,27,31,0.871,30,48,78,9,7,3,12,53,117,OOR,2005
Tayshaun Prince,SF,24,82,3039,469,963,0.487,47,138,0.341,422,825,0.512,0.511,221,274,0.807,133,302,435,247,56,71,135,161,1206,OOR,2005
Laron Profit,SF,27,42,428,56,128,0.438,8,28,0.286,48,100,0.48,0.469,16,25,0.64,24,52,76,37,16,5,27,44,136,OOR,2005
Joel Przybilla,C,25,76,1858,199,333,0.598,0,0,0.0,199,333,0.598,0.598,90,174,0.517,178,410,588,74,24,163,98,239,488,OOR,2005
Vladimir Radmanović,PF,24,63,1856,266,650,0.409,128,329,0.389,138,321,0.43,0.508,81,103,0.786,52,237,289,86,57,31,80,172,741,OOR,2005
Aleksandar Radojević,C,28,12,128,6,19,0.316,0,0,0.0,6,19,0.316,0.316,7,10,0.7,9,19,28,6,0,2,15,32,19,OOR,2005
Peter John Ramos,C,19,6,20,5,10,0.5,0,0,0.0,5,10,0.5,0.5,1,2,0.5,1,3,4,0,0,1,3,4,11,OOR,2005
Zach Randolph,PF,23,46,1603,332,741,0.448,0,6,0.0,332,735,0.452,0.448,207,254,0.815,142,300,442,86,34,17,112,112,871,OOR,2005
Theo Ratliff,C,31,63,1731,115,257,0.447,0,0,0.0,115,257,0.447,0.447,74,107,0.692,111,220,331,34,23,158,56,183,304,OOR,2005
Željko Rebrača,C,32,58,928,133,234,0.568,0,0,0.0,133,234,0.568,0.568,73,85,0.859,49,135,184,26,13,40,49,130,339,OOR,2005
Michael Redd,SG,25,75,2848,625,1418,0.441,104,293,0.355,521,1125,0.463,0.477,369,432,0.854,72,240,312,172,63,8,133,152,1723,OOR,2005
Justin Reed,SF,23,23,121,15,29,0.517,0,3,0.0,15,26,0.577,0.517,11,15,0.733,8,8,16,10,3,1,5,12,41,OOR,2005
Jared Reiner,C,22,19,132,10,30,0.333,0,0,0.0,10,30,0.333,0.333,1,4,0.25,13,25,38,1,3,7,9,35,21,OOR,2005
Jason Richardson,SG,24,72,2724,610,1368,0.446,125,370,0.338,485,998,0.486,0.492,214,309,0.693,125,299,424,281,105,32,169,156,1559,OOR,2005
Quentin Richardson,SG,24,79,2839,407,1045,0.389,226,631,0.358,181,414,0.437,0.498,136,184,0.739,91,388,479,158,96,27,102,197,1176,OOR,2005
Luke Ridnour,PG,23,82,2571,299,739,0.405,67,178,0.376,232,561,0.414,0.45,159,180,0.883,55,149,204,483,94,23,149,185,824,OOR,2005
Bernard Robinson,SG,24,31,328,36,81,0.444,3,8,0.375,33,73,0.452,0.463,18,26,0.692,14,34,48,30,11,4,20,42,93,OOR,2005
Clifford Robinson,C-PF,38,71,1689,202,523,0.386,67,193,0.347,135,330,0.409,0.45,62,97,0.639,54,155,209,104,62,53,66,181,533,OOR,2005
Glenn Robinson,SF,32,9,157,34,77,0.442,2,6,0.333,32,71,0.451,0.455,20,23,0.87,4,20,24,8,4,3,7,19,90,OOR,2005
Rodney Rogers,SF-PF,33,58,1367,172,450,0.382,48,168,0.286,124,282,0.44,0.436,52,70,0.743,61,185,246,86,41,20,86,172,444,OOR,2005
Jalen Rose,SF,32,81,2710,527,1159,0.455,108,274,0.394,419,885,0.473,0.501,333,390,0.854,44,232,276,209,63,10,180,190,1495,OOR,2005
Malik Rose,PF,30,76,1475,198,441,0.449,1,10,0.1,197,431,0.457,0.45,137,186,0.737,129,212,341,59,46,16,102,208,534,OOR,2005
Quinton Ross,SG,23,78,1659,161,373,0.432,1,4,0.25,160,369,0.434,0.433,74,110,0.673,59,151,210,109,51,22,54,165,397,OOR,2005
Michael Ruffin,C,28,79,1262,41,99,0.414,0,1,0.0,41,98,0.418,0.414,29,67,0.433,157,175,332,64,43,41,44,193,111,OOR,2005
Kareem Rush,SG,24,48,968,157,406,0.387,51,137,0.372,106,269,0.394,0.45,37,48,0.771,20,69,89,68,20,7,47,74,402,OOR,2005
Bryon Russell,SF,34,70,1026,95,252,0.377,56,149,0.376,39,103,0.379,0.488,61,77,0.792,50,122,172,72,44,11,35,130,307,OOR,2005
John Salmons,SG,25,58,993,85,210,0.405,31,91,0.341,54,119,0.454,0.479,35,48,0.729,12,109,121,114,40,13,51,92,236,OOR,2005
Jamal Sampson,PF,21,23,329,28,62,0.452,0,0,0.0,28,62,0.452,0.452,23,39,0.59,36,86,122,8,4,17,17,53,79,OOR,2005
Daniel Santiago,C,28,11,105,7,21,0.333,0,0,0.0,7,21,0.333,0.333,8,11,0.727,6,13,19,1,3,4,4,28,22,OOR,2005
Brian Scalabrine,PF,26,54,1167,132,332,0.398,22,68,0.324,110,264,0.417,0.431,53,69,0.768,83,161,244,88,34,18,66,111,339,OOR,2005
Ansu Sesay,SF,28,16,128,17,42,0.405,2,8,0.25,15,34,0.441,0.429,13,24,0.542,18,20,38,12,2,3,8,16,49,OOR,2005
Ha Seung-Jin,C,19,19,104,10,23,0.435,0,0,0.0,10,23,0.435,0.435,6,11,0.545,6,12,18,2,1,5,12,21,26,OOR,2005
Paul Shirley,PF,27,9,30,5,11,0.455,0,0,0.0,5,11,0.455,0.455,2,4,0.5,1,1,2,3,0,0,1,3,12,OOR,2005
Bobby Simmons,SF,24,75,2799,474,1017,0.466,50,115,0.435,424,902,0.47,0.491,231,273,0.846,128,318,446,205,106,16,135,227,1229,OOR,2005
Brian Skinner,C-PF,28,49,941,104,205,0.507,0,1,0.0,104,204,0.51,0.507,25,70,0.357,107,173,280,43,31,49,40,102,233,OOR,2005
Tamar Slay,SG,24,8,78,13,39,0.333,2,12,0.167,11,27,0.407,0.359,0,2,0.0,6,8,14,3,5,0,8,20,28,OOR,2005
Donta Smith,SG,21,38,433,44,113,0.389,6,22,0.273,38,91,0.418,0.416,33,48,0.688,19,33,52,39,23,5,25,50,127,OOR,2005
J.R. Smith,SG,19,76,1859,295,748,0.394,81,281,0.288,214,467,0.458,0.449,111,161,0.689,39,113,152,142,55,11,109,135,782,OOR,2005
Jabari Smith,PF,27,45,648,62,148,0.419,1,2,0.5,61,146,0.418,0.422,41,55,0.745,29,82,111,38,25,14,39,103,166,OOR,2005
Joe Smith,PF,29,74,2265,319,621,0.514,0,1,0.0,319,620,0.515,0.514,175,228,0.768,179,362,541,67,43,38,79,222,813,OOR,2005
Josh Smith,SF,19,74,2050,274,602,0.455,4,23,0.174,270,579,0.466,0.458,163,237,0.688,147,310,457,127,59,144,135,157,715,OOR,2005
Steve Smith,SG,35,50,750,102,248,0.411,41,105,0.39,61,143,0.427,0.494,69,80,0.863,15,50,65,71,14,7,27,82,314,OOR,2005
Theron Smith,SF,24,33,510,44,136,0.324,3,12,0.25,41,124,0.331,0.335,14,16,0.875,39,77,116,28,6,4,27,58,105,OOR,2005
Eric Snow,SG,31,81,1844,125,327,0.382,13,45,0.289,112,282,0.397,0.402,59,80,0.738,37,118,155,317,67,16,89,189,322,OOR,2005
Kirk Snyder,SG,21,68,906,122,328,0.372,30,85,0.353,92,243,0.379,0.418,64,96,0.667,50,71,121,36,26,19,58,116,338,OOR,2005
Darius Songaila,PF,26,81,1668,257,488,0.527,0,3,0.0,257,485,0.53,0.527,94,111,0.847,125,219,344,114,51,18,70,206,608,OOR,2005
Pape Sow,C,23,27,255,23,58,0.397,0,0,0.0,23,58,0.397,0.397,16,27,0.593,18,39,57,2,12,4,10,46,62,OOR,2005
Latrell Sprewell,SF,34,80,2450,398,961,0.414,69,211,0.327,329,750,0.439,0.45,156,188,0.83,65,189,254,179,53,21,127,124,1021,OOR,2005
Jerry Stackhouse,SG,30,56,1617,274,662,0.414,32,120,0.267,242,542,0.446,0.438,253,298,0.849,38,145,183,127,53,10,106,104,833,OOR,2005
DeShawn Stevenson,SG,23,55,1089,174,426,0.408,25,67,0.373,149,359,0.415,0.438,56,101,0.554,38,64,102,69,16,9,57,73,429,OOR,2005
Michael Stewart,PF,29,12,145,11,21,0.524,0,0,0.0,11,21,0.524,0.524,3,7,0.429,21,19,40,5,6,5,6,32,25,OOR,2005
Peja Stojaković,SF,27,66,2534,451,1016,0.444,174,433,0.402,277,583,0.475,0.53,253,275,0.92,62,223,285,138,79,12,102,157,1329,OOR,2005
Awvee Storey,SG,27,9,32,3,10,0.3,1,2,0.5,2,8,0.25,0.35,1,2,0.5,4,1,5,1,0,0,0,3,8,OOR,2005
Damon Stoudamire,PG,31,81,2762,457,1165,0.392,181,490,0.369,276,675,0.409,0.47,182,199,0.915,56,254,310,458,86,2,164,158,1277,OOR,2005
Amar'e Stoudemire,C,22,80,2889,747,1336,0.559,3,16,0.188,744,1320,0.564,0.56,583,795,0.733,219,494,713,131,77,130,189,278,2080,OOR,2005
Erick Strickland,SG,31,62,1014,114,304,0.375,21,83,0.253,93,221,0.421,0.41,52,64,0.813,11,92,103,115,30,1,64,103,301,OOR,2005
Rod Strickland,PG,38,16,196,9,43,0.209,1,2,0.5,8,41,0.195,0.221,9,10,0.9,3,24,27,39,3,2,16,15,28,OOR,2005
Bruno Šundov,C,24,21,73,11,37,0.297,1,3,0.333,10,34,0.294,0.311,2,2,1.0,6,7,13,2,2,2,6,16,25,OOR,2005
Bob Sura,PG,31,61,1922,215,504,0.427,55,155,0.355,160,349,0.458,0.481,141,188,0.75,79,258,337,317,65,7,147,168,626,OOR,2005
Mike Sweetney,C,22,77,1509,237,446,0.531,0,1,0.0,237,445,0.533,0.531,176,235,0.749,169,249,418,44,27,28,108,224,650,OOR,2005
Robert Swift,C,19,16,72,5,11,0.455,0,0,0.0,5,11,0.455,0.455,5,9,0.556,1,4,5,2,1,7,4,16,15,OOR,2005
Stromile Swift,PF,25,60,1279,219,488,0.449,0,4,0.0,219,484,0.452,0.449,166,219,0.758,92,181,273,43,41,92,90,182,604,OOR,2005
Wally Szczerbiak,SF,27,81,2558,465,919,0.506,63,169,0.373,402,750,0.536,0.54,260,304,0.855,82,221,303,191,40,16,132,178,1253,OOR,2005
Yuta Tabuse,PG,24,4,17,1,6,0.167,1,1,1.0,0,5,0.0,0.25,4,4,1.0,2,2,4,3,0,0,1,1,7,OOR,2005
Maurice Taylor,PF-C,28,65,1336,203,446,0.455,3,9,0.333,200,437,0.458,0.459,63,103,0.612,67,190,257,67,27,20,94,180,472,OOR,2005
Sebastian Telfair,PG,19,68,1330,169,430,0.393,17,69,0.246,152,361,0.421,0.413,105,133,0.789,10,94,104,224,35,4,125,120,460,OOR,2005
Jason Terry,PG,27,80,2401,372,743,0.501,103,245,0.42,269,498,0.54,0.57,146,173,0.844,38,150,188,429,109,15,147,177,993,OOR,2005
Billy Thomas,SF,29,25,356,34,94,0.362,17,56,0.304,17,38,0.447,0.452,7,9,0.778,7,29,36,17,14,1,9,29,92,OOR,2005
Etan Thomas,C,26,47,976,128,255,0.502,0,0,0.0,128,255,0.502,0.502,76,144,0.528,85,159,244,20,17,51,50,133,332,OOR,2005
James Thomas,PF,24,11,117,12,20,0.6,0,0,0.0,12,20,0.6,0.6,2,6,0.333,17,20,37,4,4,4,7,13,26,OOR,2005
John Thomas,C,29,44,521,42,86,0.488,0,0,0.0,42,86,0.488,0.488,27,46,0.587,39,58,97,17,15,13,18,82,111,OOR,2005
Kenny Thomas,PF,27,73,2167,367,781,0.47,1,5,0.2,366,776,0.472,0.471,173,227,0.762,184,351,535,152,67,17,131,227,908,OOR,2005
Kurt Thomas,PF,32,80,2855,424,901,0.471,2,4,0.5,422,897,0.47,0.472,66,84,0.786,170,661,831,160,70,79,99,310,916,OOR,2005
Tim Thomas,SF,27,71,1940,315,718,0.439,85,208,0.409,230,510,0.451,0.498,136,173,0.786,45,192,237,110,41,17,113,222,851,OOR,2005
Jamaal Tinsley,PG,26,40,1301,218,522,0.418,58,156,0.372,160,366,0.437,0.473,122,164,0.744,26,134,160,257,81,12,134,112,616,OOR,2005
Robert Traylor,C,27,74,1327,177,399,0.444,0,8,0.0,177,391,0.453,0.444,55,102,0.539,136,196,332,61,54,50,73,215,409,OOR,2005
Jake Tsakalidis,C,25,31,278,32,64,0.5,0,0,0.0,32,64,0.5,0.5,14,18,0.778,21,35,56,10,3,16,12,42,78,OOR,2005
Nikoloz Tskitishvili,PF,21,35,220,22,74,0.297,2,17,0.118,20,57,0.351,0.311,4,7,0.571,12,29,41,10,8,11,19,33,50,OOR,2005
Hedo Türkoğlu,SF,25,67,1757,328,782,0.419,93,245,0.38,235,537,0.438,0.479,188,225,0.836,62,171,233,153,41,18,119,140,937,OOR,2005
Beno Udrih,PG,22,80,1149,173,390,0.444,58,142,0.408,115,248,0.464,0.518,67,89,0.753,16,67,83,150,41,10,77,96,471,OOR,2005
Nick Van Exel,SG,33,53,1619,214,561,0.381,100,257,0.389,114,304,0.375,0.471,58,74,0.784,20,141,161,227,44,0,92,70,586,OOR,2005
Keith Van Horn,SF-PF,29,62,1502,257,564,0.456,54,142,0.38,203,422,0.481,0.504,128,157,0.815,89,205,294,75,36,21,81,170,696,OOR,2005
Anderson Varejão,PF,22,54,863,99,193,0.513,0,2,0.0,99,191,0.518,0.513,68,127,0.535,109,148,257,27,41,38,26,122,266,OOR,2005
Jacque Vaughn,SG,29,71,1410,146,325,0.449,5,15,0.333,141,310,0.455,0.457,76,91,0.835,17,90,107,135,41,1,62,138,373,OOR,2005
Jake Voskuhl,C,27,38,360,27,59,0.458,0,0,0.0,27,59,0.458,0.458,26,38,0.684,30,62,92,17,4,11,20,60,80,OOR,2005
Jackson Vroman,C-PF,23,46,705,82,199,0.412,0,3,0.0,82,196,0.418,0.412,48,75,0.64,64,111,175,40,25,19,64,105,212,OOR,2005
Sasha Vujačić,SG,20,35,403,33,117,0.282,17,63,0.27,16,54,0.296,0.355,18,19,0.947,13,49,62,51,12,2,15,41,101,OOR,2005
Dwyane Wade,SG,23,77,2974,630,1318,0.478,13,45,0.289,617,1273,0.485,0.483,581,762,0.762,110,287,397,520,121,82,321,230,1854,OOR,2005
Dajuan Wagner,SG,21,11,102,18,55,0.327,5,26,0.192,13,29,0.448,0.373,3,4,0.75,0,2,2,13,5,0,9,15,44,OOR,2005
Antoine Walker,PF,28,77,2955,581,1377,0.422,110,341,0.323,471,1036,0.455,0.462,201,373,0.539,182,513,695,265,89,58,253,217,1473,OOR,2005
Samaki Walker,PF,28,14,134,11,31,0.355,0,0,0.0,11,31,0.355,0.355,2,3,0.667,8,10,18,4,3,7,8,25,24,OOR,2005
Ben Wallace,C,30,74,2671,295,651,0.453,1,9,0.111,294,642,0.458,0.454,130,304,0.428,292,610,902,123,106,176,82,159,721,OOR,2005
Gerald Wallace,SF,22,70,2147,286,637,0.449,17,62,0.274,269,575,0.468,0.462,191,289,0.661,118,268,386,137,117,91,159,182,780,OOR,2005
Rasheed Wallace,PF,30,79,2687,467,1062,0.44,75,236,0.318,392,826,0.475,0.475,136,195,0.697,174,470,644,142,65,115,127,236,1145,OOR,2005
Luke Walton,SF,24,61,768,74,180,0.411,16,61,0.262,58,119,0.487,0.456,34,48,0.708,55,87,142,93,26,11,58,70,198,OOR,2005
Charlie Ward,PG,34,14,360,24,77,0.312,16,51,0.314,8,26,0.308,0.416,11,13,0.846,6,33,39,43,15,0,18,22,75,OOR,2005
Earl Watson,PG,25,80,1808,236,554,0.426,52,163,0.319,184,391,0.471,0.473,91,138,0.659,35,129,164,359,83,19,167,184,615,OOR,2005
Clarence Weatherspoon,PF,34,40,525,47,114,0.412,0,0,0.0,47,114,0.412,0.412,29,35,0.829,35,87,122,17,9,6,15,74,123,OOR,2005
Chris Webber,PF,31,67,2370,555,1283,0.433,15,44,0.341,540,1239,0.436,0.438,181,228,0.794,130,482,612,318,94,53,182,214,1306,OOR,2005
Bonzi Wells,SG,28,69,1489,272,617,0.441,36,104,0.346,236,513,0.46,0.47,141,188,0.75,49,180,229,80,85,27,90,165,721,OOR,2005
Jiří Welsch,SG-SF,25,71,1317,149,371,0.402,34,110,0.309,115,261,0.441,0.447,129,169,0.763,26,141,167,103,44,5,73,121,461,OOR,2005
David Wesley,SG,34,80,2774,334,840,0.398,118,315,0.375,216,525,0.411,0.468,162,189,0.857,38,190,228,265,96,9,113,215,948,OOR,2005
David West,SF,24,30,552,75,172,0.436,2,5,0.4,73,167,0.437,0.442,34,50,0.68,40,89,129,23,12,16,37,62,186,OOR,2005
Delonte West,SG,21,39,507,66,155,0.426,24,67,0.358,42,88,0.477,0.503,19,27,0.704,14,51,65,53,21,8,24,69,175,OOR,2005
Jahidi White,C,28,17,135,14,31,0.452,0,0,0.0,14,31,0.452,0.452,14,40,0.35,11,23,34,1,2,12,11,31,42,OOR,2005
Rodney White,SF,24,58,677,121,289,0.419,24,60,0.4,97,229,0.424,0.46,27,44,0.614,24,65,89,44,32,11,37,64,293,OOR,2005
Chris Wilcox,C,22,54,1005,169,329,0.514,0,0,0.0,169,329,0.514,0.514,88,144,0.611,63,165,228,38,26,24,77,129,426,OOR,2005
Damien Wilkins,SF,25,29,520,73,168,0.435,16,59,0.271,57,109,0.523,0.482,21,34,0.618,29,37,66,26,22,10,16,55,183,OOR,2005
Mike Wilks,PG,25,48,278,32,77,0.416,5,16,0.313,27,61,0.443,0.448,12,16,0.75,4,21,25,33,14,1,14,26,81,OOR,2005
Aaron Williams,C,33,42,315,29,63,0.46,0,0,0.0,29,63,0.46,0.46,15,17,0.882,17,43,60,8,5,8,17,70,73,OOR,2005
Eric Williams,SG,32,55,1322,142,330,0.43,28,73,0.384,114,257,0.444,0.473,112,161,0.696,44,128,172,92,38,4,60,147,424,OOR,2005
Frank Williams,SG,24,9,71,3,20,0.15,0,4,0.0,3,16,0.188,0.15,0,0,0.0,2,4,6,11,2,3,3,9,6,OOR,2005
Jason Williams,PG,29,71,1952,266,644,0.413,107,330,0.324,159,314,0.506,0.496,80,101,0.792,19,103,122,399,75,5,130,91,719,OOR,2005
Jerome Williams,SF,31,79,1211,122,243,0.502,0,5,0.0,122,238,0.513,0.502,115,172,0.669,115,168,283,41,55,10,65,155,359,OOR,2005
Mo Williams,PG,22,80,2254,323,737,0.438,32,99,0.323,291,638,0.456,0.46,136,160,0.85,50,194,244,484,74,11,196,221,814,OOR,2005
Scott Williams,C,36,19,152,12,41,0.293,0,1,0.0,12,40,0.3,0.293,9,11,0.818,15,15,30,8,4,6,5,30,33,OOR,2005
Corliss Williamson,PF,31,72,1527,273,584,0.467,0,2,0.0,273,582,0.469,0.467,195,244,0.799,104,155,259,78,38,15,86,218,741,OOR,2005
Kevin Willis,C,42,29,344,35,90,0.389,0,2,0.0,35,88,0.398,0.389,17,23,0.739,29,47,76,9,8,7,15,53,87,OOR,2005
Loren Woods,C,26,45,712,71,164,0.433,0,1,0.0,71,163,0.436,0.433,34,59,0.576,81,139,220,17,8,39,37,78,176,OOR,2005
Qyntel Woods,SF,23,3,40,5,12,0.417,0,0,0.0,5,12,0.417,0.417,0,0,0.0,2,4,6,0,4,0,2,6,10,OOR,2005
Metta World Peace,SF,25,7,291,59,119,0.496,7,17,0.412,52,102,0.51,0.525,47,51,0.922,8,37,45,22,12,6,17,27,172,OOR,2005
Dorell Wright,SF,19,3,27,3,11,0.273,0,4,0.0,3,7,0.429,0.273,1,1,1.0,0,1,1,3,4,0,3,2,7,OOR,2005
Lorenzen Wright,C,29,80,2287,320,683,0.469,0,3,0.0,320,680,0.471,0.469,131,198,0.662,177,436,613,87,58,69,100,251,771,OOR,2005
Wang Zhizhi,C,27,20,92,17,36,0.472,2,3,0.667,15,33,0.455,0.5,7,12,0.583,6,12,18,5,3,2,5,9,43,OOR,2005
