Player,Pos,Age,G,MP,FG,FGA,FG%,3P,3PA,3P%,2P,2PA,2P%,eFG%,FT,FTA,FT%,ORB,DRB,TRB,AST,STL,BLK,TOV,PF,PTS,Status
Alex Acker,SG,26,25,199,30,76,0.395,7,20,0.35,23,56,0.411,0.441,5,10,0.5,8,16,24,12,5,4,7,9,72,OOR
Hassan Adams,SG,24,12,52,4,13,0.308,0,0,0.0,4,13,0.308,0.308,3,6,0.5,1,6,7,1,1,1,4,4,11,OOR
Arron Afflalo,SG,23,74,1234,131,300,0.437,43,107,0.402,88,193,0.456,0.508,58,71,0.817,30,104,134,44,28,13,43,144,363,OOR
Maurice Ager,SG,24,20,97,15,43,0.349,0,6,0.0,15,37,0.405,0.349,4,8,0.5,3,7,10,3,1,2,4,17,34,OOR
Blake Ahearn,PG,24,3,19,2,6,0.333,2,4,0.5,0,2,0.0,0.5,2,2,1.0,0,1,1,2,1,0,1,3,8,OOR
Alexis Ajinça,PF,20,31,182,25,69,0.362,0,2,0.0,25,67,0.373,0.362,20,28,0.714,9,21,30,3,7,6,12,34,70,OOR
LaMarcus Aldridge,PF,23,81,3004,601,1243,0.484,7,28,0.25,594,1215,0.489,0.486,261,334,0.781,234,371,605,157,77,77,121,207,1470,OOR
Joe Alexander,SF,22,59,716,102,245,0.416,16,46,0.348,86,199,0.432,0.449,58,83,0.699,44,71,115,42,15,29,52,107,278,OOR
Malik Allen,PF,30,49,579,73,170,0.429,0,1,0.0,73,169,0.432,0.429,10,21,0.476,35,68,103,35,7,12,20,89,156,OOR
Ray Allen,SG,33,79,2876,499,1040,0.48,199,486,0.409,300,554,0.542,0.575,237,249,0.952,66,212,278,218,69,13,134,157,1434,OOR
Tony Allen,SG,27,46,887,137,284,0.482,6,27,0.222,131,257,0.51,0.493,79,109,0.725,22,82,104,66,54,23,77,98,359,OOR
Morris Almond,SG,23,25,255,33,81,0.407,5,17,0.294,28,64,0.438,0.438,21,26,0.808,9,27,36,7,4,4,16,31,92,OOR
Rafer Alston,PG,32,77,2447,316,820,0.385,112,331,0.338,204,489,0.417,0.454,156,208,0.75,33,194,227,406,108,10,140,135,900,OOR
Lou Amundson,PF,26,76,1044,134,250,0.536,0,1,0.0,134,249,0.538,0.536,53,120,0.442,128,142,270,28,32,65,56,154,321,OOR
Chris Andersen,C,30,71,1460,160,292,0.548,2,10,0.2,158,282,0.56,0.551,130,181,0.718,163,279,442,31,41,175,69,174,452,OOR
Ryan Anderson,PF,20,66,1312,160,407,0.393,69,189,0.365,91,218,0.417,0.478,98,116,0.845,104,207,311,52,44,20,63,157,487,OOR
Carmelo Anthony,SF,24,66,2277,535,1207,0.443,63,170,0.371,472,1037,0.455,0.469,371,468,0.793,106,344,450,222,75,24,199,195,1504,OOR
Joel Anthony,C,26,65,1048,57,118,0.483,0,0,0.0,57,118,0.483,0.483,30,46,0.652,89,108,197,27,20,93,41,139,144,OOR
Gilbert Arenas,PG,27,2,63,6,23,0.261,2,7,0.286,4,16,0.25,0.304,12,16,0.75,1,8,9,20,0,1,1,4,26,OOR
Trevor Ariza,SF,23,82,1999,274,596,0.46,61,191,0.319,213,405,0.526,0.511,120,169,0.71,111,241,352,145,137,24,87,166,729,OOR
Hilton Armstrong,C,24,70,1092,138,246,0.561,0,2,0.0,138,244,0.566,0.561,62,98,0.633,81,114,195,29,26,45,80,181,338,OOR
Darrell Arthur,PF,20,76,1464,191,436,0.438,0,2,0.0,191,434,0.44,0.438,40,60,0.667,108,238,346,43,52,52,47,206,422,OOR
Chucky Atkins,PG,34,33,412,34,113,0.301,15,57,0.263,19,56,0.339,0.367,15,16,0.938,5,19,24,59,10,2,23,27,98,OOR
D.J. Augustin,PG,21,72,1908,267,621,0.43,108,246,0.439,159,375,0.424,0.517,208,233,0.893,17,116,133,250,42,2,119,140,850,OOR
Kelenna Azubuike,SF,25,74,2375,392,845,0.464,94,210,0.448,298,635,0.469,0.52,185,229,0.808,112,258,370,117,57,50,95,183,1063,OOR
Renaldo Balkman,PF,24,53,780,110,197,0.558,2,7,0.286,108,190,0.568,0.563,42,65,0.646,86,117,203,34,47,23,35,98,264,OOR
Marcus Banks,PG,27,22,206,21,57,0.368,3,19,0.158,18,38,0.474,0.395,11,18,0.611,1,17,18,28,11,2,14,26,56,OOR
Leandro Barbosa,SG,26,70,1705,366,759,0.482,90,240,0.375,276,519,0.532,0.542,171,194,0.881,34,147,181,162,82,7,93,115,993,OOR
J.J. Barea,SG,24,79,1600,246,557,0.442,55,154,0.357,191,403,0.474,0.491,70,93,0.753,36,141,177,269,37,5,105,121,617,OOR
Andrea Bargnani,PF,23,78,2453,431,958,0.45,119,291,0.409,312,667,0.468,0.512,221,266,0.831,70,346,416,94,34,97,135,242,1202,OOR
Matt Barnes,PF,28,77,2082,285,674,0.423,117,341,0.343,168,333,0.505,0.51,101,136,0.743,79,342,421,212,52,26,130,209,788,OOR
Brent Barry,SG,37,56,857,70,172,0.407,49,131,0.374,21,41,0.512,0.549,19,20,0.95,17,77,94,78,24,3,48,45,208,OOR
Brandon Bass,C,23,81,1574,252,508,0.496,0,6,0.0,252,502,0.502,0.496,182,210,0.867,129,238,367,43,27,55,86,140,686,OOR
Maceo Baston,PF,33,27,217,25,46,0.543,0,1,0.0,25,45,0.556,0.543,17,27,0.63,22,30,52,7,6,10,12,39,67,OOR
Tony Battie,PF,32,77,1202,158,323,0.489,2,9,0.222,156,314,0.497,0.492,54,82,0.659,92,186,278,31,26,25,46,112,372,OOR
Shane Battier,SG,30,60,2031,145,354,0.41,91,237,0.384,54,117,0.462,0.538,55,67,0.821,52,233,285,137,48,54,49,114,436,OOR
Nicolas Batum,SF,20,79,1454,161,361,0.446,62,168,0.369,99,193,0.513,0.532,42,52,0.808,84,136,220,74,50,40,50,139,426,OOR
Jerryd Bayless,PG,20,53,655,69,189,0.365,7,27,0.259,62,162,0.383,0.384,83,103,0.806,8,49,57,78,16,2,56,81,228,OOR
Michael Beasley,PF,20,81,2009,452,957,0.472,33,81,0.407,419,876,0.478,0.49,186,241,0.772,110,329,439,83,41,37,121,184,1123,OOR
Marco Belinelli,SG,22,42,882,140,317,0.442,52,131,0.397,88,186,0.473,0.524,40,52,0.769,10,61,71,88,36,1,59,73,372,OOR
Charlie Bell,SG,29,70,1783,217,524,0.414,87,240,0.363,130,284,0.458,0.497,66,80,0.825,32,102,134,151,50,7,76,138,587,OOR
Raja Bell,SG,32,67,2315,299,684,0.437,114,271,0.421,185,413,0.448,0.52,87,102,0.853,41,202,243,142,50,8,86,166,799,OOR
Mike Bibby,PG,30,79,2740,437,1005,0.435,167,428,0.39,270,577,0.468,0.518,135,171,0.789,38,240,278,392,98,11,128,145,1176,OOR
Andris Biedriņš,C,22,62,1863,308,533,0.578,0,1,0.0,308,532,0.579,0.578,119,216,0.551,223,470,693,121,63,96,110,236,735,OOR
Chauncey Billups,PG,32,79,2789,410,980,0.418,162,397,0.408,248,583,0.425,0.501,418,458,0.913,32,207,239,506,93,18,177,161,1400,OOR
Steve Blake,PG,28,69,2188,277,647,0.428,140,328,0.427,137,319,0.429,0.536,63,75,0.84,28,145,173,348,69,4,108,126,757,OOR
Andray Blatche,C,22,71,1703,297,630,0.471,5,21,0.238,292,609,0.479,0.475,114,162,0.704,126,252,378,118,53,74,117,211,713,OOR
Mark Blount,C,33,20,207,30,78,0.385,11,27,0.407,19,51,0.373,0.455,8,13,0.615,10,31,41,4,1,7,14,17,79,OOR
Keith Bogans,SG,28,65,1272,119,324,0.367,74,218,0.339,45,106,0.425,0.481,52,57,0.912,31,171,202,64,43,4,41,105,364,OOR
Andrew Bogut,C,24,36,1124,183,317,0.577,0,0,0.0,183,317,0.577,0.577,56,98,0.571,117,252,369,72,23,37,86,130,422,OOR
Matt Bonner,PF,28,81,1928,266,536,0.496,118,268,0.44,148,268,0.552,0.606,17,23,0.739,97,289,386,82,47,26,37,190,667,OOR
Josh Boone,C,24,62,995,113,214,0.528,0,0,0.0,113,214,0.528,0.528,32,85,0.376,104,154,258,31,22,48,31,106,258,OOR
Calvin Booth,C,32,8,56,5,10,0.5,0,0,0.0,5,10,0.5,0.5,6,8,0.75,5,6,11,0,1,2,1,10,16,OOR
Carlos Boozer,PF,27,37,1197,251,512,0.49,0,0,0.0,251,512,0.49,0.49,97,139,0.698,111,274,385,79,39,7,79,132,599,OOR
Chris Bosh,C,24,77,2928,615,1263,0.487,12,49,0.245,603,1214,0.497,0.492,504,617,0.817,215,556,771,191,67,77,174,189,1746,OOR
Bruce Bowen,SF,37,80,1506,79,187,0.422,42,98,0.429,37,89,0.416,0.535,14,26,0.538,16,129,145,40,36,13,25,123,214,OOR
Ryan Bowen,SF,33,21,219,22,38,0.579,0,0,0.0,22,38,0.579,0.579,3,5,0.6,10,14,24,9,14,5,5,37,47,OOR
Elton Brand,PF,29,29,920,163,365,0.447,0,0,0.0,163,365,0.447,0.447,73,108,0.676,77,177,254,37,17,45,68,78,399,OOR
Corey Brewer,SF,22,15,307,37,90,0.411,5,12,0.417,32,78,0.41,0.439,14,19,0.737,18,31,49,25,15,3,13,37,93,OOR
Ronnie Brewer,SF,23,81,2605,421,828,0.508,22,85,0.259,399,743,0.537,0.522,247,352,0.702,101,199,300,179,138,30,110,128,1111,OOR
Aaron Brooks,PG,24,80,1998,316,783,0.404,113,309,0.366,203,474,0.428,0.476,149,172,0.866,33,124,157,238,46,8,125,152,894,OOR
Andre Brown,PF,27,4,41,1,7,0.143,0,0,0.0,1,7,0.143,0.143,2,2,1.0,7,5,12,1,1,0,5,9,4,OOR
Bobby Brown,SG-PG,24,68,931,141,360,0.392,45,130,0.346,96,230,0.417,0.454,34,43,0.791,14,38,52,117,21,3,63,95,361,OOR
Dee Brown,PG,24,19,261,18,49,0.367,7,24,0.292,11,25,0.44,0.439,3,5,0.6,7,22,29,36,10,0,17,28,46,OOR
Devin Brown,SG,30,63,869,111,313,0.355,28,97,0.289,83,216,0.384,0.399,78,100,0.78,31,88,119,54,32,5,54,81,328,OOR
Kwame Brown,C,26,58,999,90,169,0.533,0,0,0.0,90,169,0.533,0.533,63,122,0.516,91,199,290,32,24,24,50,138,243,OOR
Shannon Brown,SG,23,48,477,78,165,0.473,14,37,0.378,64,128,0.5,0.515,32,39,0.821,11,33,44,38,22,7,38,42,202,OOR
Kobe Bryant,SG,30,82,2960,800,1712,0.467,118,336,0.351,682,1376,0.496,0.502,483,564,0.856,90,339,429,399,120,37,210,189,2201,Candidate
Greg Buckner,SF,32,63,878,61,159,0.384,13,51,0.255,48,108,0.444,0.425,20,25,0.8,32,98,130,57,29,8,38,108,155,OOR
Caron Butler,SG,28,67,2585,491,1085,0.453,65,210,0.31,426,875,0.487,0.482,345,402,0.858,118,296,414,290,106,20,210,165,1392,OOR
Rasual Butler,SF,29,82,2614,348,803,0.433,140,359,0.39,208,444,0.468,0.521,86,110,0.782,49,222,271,75,51,61,59,159,922,OOR
Andrew Bynum,C,21,50,1446,281,502,0.56,0,0,0.0,281,502,0.56,0.56,152,215,0.707,137,261,398,71,18,90,85,157,714,OOR
Will Bynum,PG,26,57,803,156,342,0.456,3,19,0.158,153,323,0.474,0.461,95,119,0.798,19,56,75,157,34,2,76,85,410,OOR
José Calderón,PG,27,68,2333,320,644,0.497,82,202,0.406,238,442,0.538,0.561,151,154,0.981,16,178,194,607,74,7,143,114,873,OOR
Marcus Camby,C,34,62,1925,254,496,0.512,1,4,0.25,253,492,0.514,0.513,132,182,0.725,161,529,690,127,51,132,93,129,641,OOR
Brian Cardinal,PF,31,64,909,65,169,0.385,30,92,0.326,35,77,0.455,0.473,30,35,0.857,39,103,142,76,37,13,48,135,190,OOR
Rodney Carney,SG,24,67,1199,176,423,0.416,79,226,0.35,97,197,0.492,0.509,50,66,0.758,36,90,126,26,45,29,43,94,481,OOR
Matt Carroll,SG,28,55,616,65,171,0.38,13,53,0.245,52,118,0.441,0.418,21,25,0.84,7,62,69,27,21,6,33,67,164,OOR
Anthony Carter,PG,33,78,1787,167,386,0.433,21,88,0.239,146,298,0.49,0.46,57,78,0.731,40,165,205,364,96,13,155,142,412,OOR
Vince Carter,SG,32,80,2946,588,1345,0.437,151,392,0.385,437,953,0.459,0.493,335,410,0.817,74,336,410,376,82,38,166,234,1662,OOR
Mario Chalmers,PG,22,82,2626,278,662,0.42,114,311,0.367,164,351,0.467,0.506,148,193,0.767,37,191,228,403,160,8,165,240,818,OOR
Tyson Chandler,C,26,45,1445,160,283,0.565,0,0,0.0,160,283,0.565,0.565,77,133,0.579,163,230,393,22,15,56,70,144,397,OOR
Wilson Chandler,SF,21,82,2735,455,1054,0.432,103,314,0.328,352,740,0.476,0.481,171,215,0.795,91,354,445,170,71,75,139,250,1184,OOR
Speedy Claxton,PG,30,2,15,2,7,0.286,0,0,0.0,2,7,0.286,0.286,1,2,0.5,0,0,0,3,0,0,0,1,5,OOR
Jarron Collins,C,30,26,201,16,35,0.457,0,0,0.0,16,35,0.457,0.457,8,11,0.727,20,17,37,7,2,1,9,35,40,OOR
Jason Collins,C,30,31,422,22,70,0.314,0,0,0.0,22,70,0.314,0.314,13,28,0.464,28,42,70,11,9,13,12,73,57,OOR
Mardy Collins,PG-SG,24,48,890,105,247,0.425,13,31,0.419,92,216,0.426,0.451,28,46,0.609,31,76,107,111,31,10,58,80,251,OOR
Nick Collison,C,28,71,1831,243,428,0.568,0,2,0.0,243,426,0.57,0.568,98,136,0.721,181,308,489,66,51,50,73,239,584,OOR
Mike Conley,PG,21,82,2508,323,730,0.442,88,217,0.406,235,513,0.458,0.503,161,197,0.817,25,251,276,354,90,8,143,146,895,OOR
Brian Cook,PF,28,30,171,28,76,0.368,13,30,0.433,15,46,0.326,0.454,5,6,0.833,7,25,32,5,3,3,13,26,74,OOR
Daequan Cook,SF,21,75,1833,242,645,0.375,153,395,0.387,89,250,0.356,0.494,49,56,0.875,19,170,189,71,39,10,42,125,686,OOR
Jamal Crawford,PG-SG,28,65,2479,419,1022,0.41,142,394,0.36,277,628,0.441,0.479,300,344,0.872,23,170,193,288,57,13,148,92,1280,OOR
Joe Crawford,SF,22,2,23,3,10,0.3,1,4,0.25,2,6,0.333,0.35,2,2,1.0,1,3,4,1,1,0,0,2,9,OOR
Javaris Crittenton,PG-SG,21,63,1174,131,285,0.46,2,15,0.133,129,270,0.478,0.463,53,92,0.576,57,109,166,150,40,6,82,101,317,OOR
Austin Croshere,PF,33,14,100,14,39,0.359,5,15,0.333,9,24,0.375,0.423,7,12,0.583,11,23,34,9,1,1,6,5,40,OOR
Eddy Curry,C,26,3,12,2,2,1.0,0,0,0.0,2,2,1.0,1.0,1,3,0.333,0,4,4,0,0,0,2,5,5,OOR
Samuel Dalembert,C,27,82,2036,216,434,0.498,0,2,0.0,216,432,0.5,0.498,91,124,0.734,214,487,701,18,33,146,117,248,523,OOR
Erick Dampier,C,33,80,1836,182,280,0.65,0,0,0.0,182,280,0.65,0.65,90,141,0.638,216,349,565,77,24,95,74,191,454,OOR
Antonio Daniels,PG,33,74,1021,99,236,0.419,22,60,0.367,77,176,0.438,0.466,80,100,0.8,5,72,77,177,26,1,62,55,300,OOR
Marquis Daniels,SF,28,54,1700,311,689,0.451,18,90,0.2,293,599,0.489,0.464,93,129,0.721,80,168,248,114,62,26,94,120,733,OOR
Jermareo Davidson,SF,24,14,111,17,35,0.486,0,0,0.0,17,35,0.486,0.486,8,17,0.471,10,24,34,1,2,3,5,12,42,OOR
Baron Davis,PG,29,65,2248,355,959,0.37,99,328,0.302,256,631,0.406,0.422,159,210,0.757,46,192,238,501,108,35,193,193,968,OOR
Glen Davis,C,23,76,1637,199,450,0.442,2,5,0.4,197,445,0.443,0.444,130,178,0.73,121,180,301,69,53,19,71,230,530,OOR
Paul Davis,PF,24,27,320,40,98,0.408,0,1,0.0,40,97,0.412,0.408,27,34,0.794,28,39,67,12,10,3,13,44,107,OOR
Ricky Davis,SG,29,36,785,83,245,0.339,35,111,0.315,48,134,0.358,0.41,31,36,0.861,9,51,60,82,19,5,39,63,232,OOR
Luol Deng,SF,23,49,1665,265,591,0.448,8,20,0.4,257,571,0.45,0.455,152,191,0.796,80,215,295,94,60,25,72,85,690,OOR
Boris Diaw,PF,26,81,2754,448,884,0.507,75,181,0.414,373,703,0.531,0.549,101,147,0.687,118,314,432,333,61,53,215,202,1072,OOR
Yakhouba Diawara,SF,26,63,851,76,217,0.35,51,163,0.313,25,54,0.463,0.468,10,19,0.526,26,56,82,27,13,6,16,75,213,OOR
Travis Diener,PG,26,55,719,74,179,0.413,46,118,0.39,28,61,0.459,0.542,12,15,0.8,6,80,86,122,26,5,21,42,206,OOR
Ike Diogu,PF,25,29,215,39,74,0.527,1,2,0.5,38,72,0.528,0.534,40,53,0.755,26,30,56,3,3,3,12,23,119,OOR
DeSagana Diop,C,27,75,1036,74,171,0.433,0,0,0.0,74,171,0.433,0.433,22,66,0.333,114,159,273,32,29,56,39,128,170,OOR
Juan Dixon,PG,30,50,816,101,256,0.395,25,75,0.333,76,181,0.42,0.443,34,39,0.872,8,59,67,118,35,6,70,74,261,OOR
Keyon Dooling,PG,28,77,2074,261,598,0.436,99,235,0.421,162,363,0.446,0.519,127,154,0.825,24,131,155,270,71,8,105,135,748,OOR
Joey Dorsey,PF,25,3,6,1,2,0.5,0,0,0.0,1,2,0.5,0.5,0,0,0.0,0,1,1,1,0,0,0,0,2,OOR
Quincy Douby,PG,24,27,300,42,110,0.382,14,46,0.304,28,64,0.438,0.445,17,19,0.895,6,26,32,25,5,5,13,27,115,OOR
Chris Douglas-Roberts,SG,22,44,585,81,176,0.46,3,12,0.25,78,164,0.476,0.469,51,62,0.823,14,36,50,52,12,7,31,34,216,OOR
Goran Dragić,PG,22,55,728,88,224,0.393,20,54,0.37,68,170,0.4,0.438,50,65,0.769,33,70,103,111,29,3,73,87,246,OOR
Jared Dudley,SF,23,68,1155,136,285,0.477,29,74,0.392,107,211,0.507,0.528,71,105,0.676,82,123,205,56,57,8,43,105,372,OOR
Chris Duhon,PG,26,79,2906,287,681,0.421,127,325,0.391,160,356,0.449,0.515,179,209,0.856,45,201,246,566,72,7,221,126,880,OOR
Tim Duncan,C,32,75,2524,558,1107,0.504,0,2,0.0,558,1105,0.505,0.504,334,483,0.692,201,599,800,264,38,126,165,173,1450,OOR
Mike Dunleavy,SG,28,18,495,93,232,0.401,32,90,0.356,61,142,0.43,0.47,53,65,0.815,14,54,68,44,12,9,38,36,271,OOR
Kevin Durant,SF,20,74,2885,661,1390,0.476,97,230,0.422,564,1160,0.486,0.51,452,524,0.863,77,405,482,205,96,53,225,134,1871,OOR
Monta Ellis,SG,23,25,892,194,430,0.451,8,26,0.308,186,404,0.46,0.46,78,94,0.83,14,94,108,93,39,8,67,67,474,OOR
Francisco Elson,C,32,59,977,83,169,0.491,1,4,0.25,82,165,0.497,0.494,33,39,0.846,100,129,229,32,36,36,48,144,200,OOR
Melvin Ely,C,30,31,373,37,95,0.389,0,0,0.0,37,95,0.389,0.389,23,36,0.639,30,34,64,18,2,9,23,58,97,OOR
Maurice Evans,SF,30,80,1840,208,482,0.432,98,248,0.395,110,234,0.47,0.533,60,73,0.822,88,155,243,54,50,10,43,163,574,OOR
Reggie Evans,PF,28,79,1137,79,178,0.444,0,1,0.0,79,177,0.446,0.444,104,175,0.594,135,226,361,26,41,8,69,161,262,OOR
Jordan Farmar,PG,22,65,1192,161,412,0.391,49,146,0.336,112,266,0.421,0.45,45,77,0.584,22,95,117,155,57,10,87,105,416,OOR
Desmon Farmer,SG,27,3,54,4,14,0.286,3,12,0.25,1,2,0.5,0.393,2,2,1.0,0,6,6,2,0,0,4,6,13,OOR
Raymond Felton,PG,24,82,3086,442,1083,0.408,59,207,0.285,383,876,0.437,0.435,219,272,0.805,54,256,310,553,126,30,228,191,1162,OOR
Rudy Fernández,SG,23,78,1993,268,630,0.425,159,398,0.399,109,232,0.47,0.552,120,143,0.839,47,160,207,159,69,12,86,111,815,OOR
Kyrylo Fesenko,C,22,21,156,21,36,0.583,0,0,0.0,21,36,0.583,0.583,7,21,0.333,14,23,37,4,7,15,9,35,49,OOR
Michael Finley,SF,35,81,2336,301,689,0.437,131,319,0.411,170,370,0.459,0.532,51,62,0.823,26,244,270,114,37,17,61,82,784,OOR
Derek Fisher,PG,34,82,2441,292,688,0.424,120,302,0.397,172,386,0.446,0.512,110,130,0.846,25,163,188,261,95,6,72,187,814,OOR
T.J. Ford,PG,25,74,2258,413,913,0.452,35,104,0.337,378,809,0.467,0.472,245,281,0.872,59,200,259,392,89,16,180,180,1106,OOR
Jeff Foster,C,32,74,1828,177,353,0.501,2,7,0.286,175,346,0.506,0.504,96,146,0.658,215,293,508,130,53,49,88,229,452,OOR
Randy Foye,SG,25,70,2494,399,981,0.407,111,308,0.36,288,673,0.428,0.463,230,272,0.846,34,180,214,303,72,26,150,201,1139,OOR
Adonal Foyle,C,33,10,62,7,11,0.636,0,0,0.0,7,11,0.636,0.636,3,6,0.5,9,17,26,1,0,8,3,5,17,OOR
Channing Frye,PF,25,63,746,113,267,0.423,11,33,0.333,102,234,0.436,0.444,26,36,0.722,41,99,140,24,17,16,29,106,263,OOR
Dan Gadzuric,C,30,67,941,117,244,0.48,0,2,0.0,117,242,0.483,0.48,37,68,0.544,95,160,255,39,32,43,41,162,271,OOR
Danilo Gallinari,SG,20,28,412,56,125,0.448,32,72,0.444,24,53,0.453,0.576,26,27,0.963,13,42,55,15,14,4,15,48,170,OOR
Francisco García,SF,27,65,1975,295,665,0.444,88,221,0.398,207,444,0.466,0.51,146,178,0.82,56,162,218,150,80,67,112,196,824,OOR
Thomas Gardner,SG,23,16,98,9,36,0.25,4,23,0.174,5,13,0.385,0.306,2,4,0.5,0,7,7,2,4,1,3,4,24,OOR
Kevin Garnett,PF,32,57,1772,393,740,0.531,2,8,0.25,391,732,0.534,0.532,111,132,0.841,78,407,485,144,63,68,90,128,899,OOR
Marc Gasol,C,24,82,2521,350,661,0.53,0,1,0.0,350,660,0.53,0.53,275,375,0.733,201,404,605,143,63,90,164,265,975,OOR
Pau Gasol,C,28,81,2999,592,1045,0.567,1,2,0.5,591,1043,0.567,0.567,343,439,0.781,262,518,780,284,52,81,157,172,1528,OOR
Rudy Gay,SF,22,79,2945,572,1262,0.453,85,242,0.351,487,1020,0.477,0.487,264,344,0.767,109,328,437,135,98,59,203,221,1493,OOR
Devean George,SF,31,43,708,54,142,0.38,22,76,0.289,32,66,0.485,0.458,17,22,0.773,25,53,78,15,23,11,17,57,147,OOR
Daniel Gibson,PG,22,75,1795,206,527,0.391,108,283,0.382,98,244,0.402,0.493,66,86,0.767,31,124,155,132,44,16,61,163,586,OOR
J.R. Giddens,SF,23,6,8,2,3,0.667,0,0,0.0,2,3,0.667,0.667,0,0,0.0,2,1,3,0,1,0,1,1,4,OOR
Eddie Gill,PG,30,6,43,6,9,0.667,2,3,0.667,4,6,0.667,0.778,0,0,0.0,0,4,4,11,3,1,5,10,14,OOR
Manu Ginóbili,SG,31,44,1181,223,491,0.454,69,209,0.33,154,282,0.546,0.524,168,190,0.884,24,174,198,157,64,16,88,90,683,OOR
Ryan Gomes,SF,26,82,2614,420,974,0.431,106,285,0.372,314,689,0.456,0.486,146,181,0.807,106,286,392,135,63,22,128,183,1092,OOR
Drew Gooden,PF,27,51,1264,237,506,0.468,0,4,0.0,237,502,0.472,0.468,131,156,0.84,113,249,362,48,30,18,76,144,605,OOR
Ben Gordon,SG,25,82,2999,598,1315,0.455,173,422,0.41,425,893,0.476,0.521,330,382,0.864,52,231,283,279,71,22,200,184,1699,OOR
Eric Gordon,SG,20,78,2677,411,901,0.456,131,337,0.389,280,564,0.496,0.529,299,350,0.854,45,156,201,215,78,35,164,172,1252,OOR
Marcin Gortat,PF,24,63,794,106,187,0.567,1,1,1.0,105,186,0.565,0.57,26,45,0.578,96,190,286,14,18,53,25,111,239,OOR
Joey Graham,SF,26,78,1541,231,480,0.481,3,16,0.188,228,464,0.491,0.484,132,160,0.825,95,197,292,48,35,12,74,191,597,OOR
Stephen Graham,SG,26,52,684,106,256,0.414,20,66,0.303,86,190,0.453,0.453,50,62,0.806,21,75,96,33,10,4,45,82,282,OOR
Danny Granger,SF,25,67,2424,571,1277,0.447,182,450,0.404,389,827,0.47,0.518,404,460,0.878,49,292,341,183,69,97,165,207,1728,OOR
Aaron Gray,C,24,56,715,81,167,0.485,0,1,0.0,81,166,0.488,0.485,34,59,0.576,84,136,220,46,14,18,40,135,196,OOR
Gerald Green,SG,23,38,376,79,180,0.439,14,46,0.304,65,134,0.485,0.478,27,32,0.844,14,40,54,15,10,5,33,51,199,OOR
Jeff Green,PF,22,78,2873,476,1068,0.446,96,247,0.389,380,821,0.463,0.491,242,307,0.788,120,399,519,155,81,33,173,202,1290,OOR
Willie Green,SG,27,81,1828,286,658,0.435,51,161,0.317,235,497,0.473,0.473,62,85,0.729,29,97,126,158,53,13,64,154,685,OOR
Donté Greene,SF,20,55,725,77,236,0.326,26,100,0.26,51,136,0.375,0.381,29,34,0.853,19,67,86,30,16,14,37,68,209,OOR
Hamed Haddadi,C,23,19,120,15,31,0.484,0,0,0.0,15,31,0.484,0.484,18,30,0.6,16,31,47,8,1,12,9,20,48,OOR
Malik Hairston,SG,21,15,155,24,49,0.49,0,1,0.0,24,48,0.5,0.49,2,7,0.286,11,17,28,13,6,7,12,19,50,OOR
Richard Hamilton,SG,30,67,2279,466,1043,0.447,70,190,0.368,396,853,0.464,0.48,223,263,0.848,44,163,207,297,40,4,133,176,1225,OOR
Matt Harpring,SG,32,63,693,111,241,0.461,0,2,0.0,111,239,0.464,0.461,55,72,0.764,47,76,123,28,29,9,29,102,277,OOR
Al Harrington,PF,28,73,2546,532,1212,0.439,171,470,0.364,361,742,0.487,0.509,234,295,0.793,99,356,455,102,88,22,161,227,1469,OOR
Devin Harris,PG,25,69,2494,455,1039,0.438,64,220,0.291,391,819,0.477,0.469,496,605,0.82,30,201,231,476,114,13,212,164,1470,OOR
Jason Hart,PG,30,39,348,30,94,0.319,0,6,0.0,30,88,0.341,0.319,18,23,0.783,13,33,46,48,12,4,22,39,78,OOR
Udonis Haslem,PF,28,75,2560,333,643,0.518,0,0,0.0,333,643,0.518,0.518,128,170,0.753,169,449,618,85,43,25,82,204,794,OOR
Trenton Hassell,SF,29,53,1094,86,191,0.45,2,8,0.25,84,183,0.459,0.455,20,25,0.8,50,96,146,51,21,16,30,92,194,OOR
Spencer Hawes,C,20,77,2259,373,800,0.466,40,115,0.348,333,685,0.486,0.491,90,136,0.662,148,401,549,149,44,93,160,249,876,OOR
Chuck Hayes,C,25,71,858,42,113,0.372,0,4,0.0,42,109,0.385,0.372,7,19,0.368,74,176,250,42,34,19,25,134,91,OOR
Jarvis Hayes,SF,27,74,1832,257,577,0.445,94,244,0.385,163,333,0.489,0.527,36,52,0.692,27,240,267,54,52,7,49,162,644,OOR
Brendan Haywood,C,29,6,175,24,50,0.48,0,0,0.0,24,50,0.48,0.48,10,21,0.476,13,31,44,8,4,15,9,14,58,OOR
Luther Head,PG-SG,26,32,498,55,144,0.382,20,54,0.37,35,90,0.389,0.451,19,24,0.792,6,46,52,58,17,2,25,37,149,OOR
Walter Herrmann,SF,29,59,630,82,207,0.396,41,120,0.342,41,87,0.471,0.495,19,25,0.76,28,79,107,22,7,4,17,43,224,OOR
Roy Hibbert,C,22,70,1009,198,420,0.471,0,0,0.0,198,420,0.471,0.471,98,147,0.667,115,128,243,49,20,76,55,215,494,OOR
J.J. Hickson,C,20,62,705,100,194,0.515,0,0,0.0,100,194,0.515,0.515,45,67,0.672,52,113,165,9,14,30,45,81,245,OOR
Nenê,C,26,77,2510,428,709,0.604,1,5,0.2,427,704,0.607,0.604,266,368,0.723,183,415,598,108,95,101,147,278,1123,OOR
George Hill,PG,22,77,1270,150,372,0.403,24,73,0.329,126,299,0.421,0.435,114,146,0.781,30,128,158,136,45,21,74,150,438,OOR
Grant Hill,SF,36,82,2445,390,745,0.523,24,76,0.316,366,669,0.547,0.54,181,224,0.808,64,341,405,186,90,54,126,182,985,OOR
Steven Hill,PF,23,1,2,1,1,1.0,0,0,0.0,1,1,1.0,1.0,0,0,0.0,2,1,3,0,0,0,0,0,2,OOR
Kirk Hinrich,SG,28,51,1339,183,419,0.437,69,169,0.408,114,250,0.456,0.519,68,86,0.791,16,107,123,197,66,19,87,126,503,OOR
Ryan Hollins,C,24,45,444,50,94,0.532,0,0,0.0,50,94,0.532,0.532,43,72,0.597,46,51,97,7,7,32,24,78,143,OOR
Al Horford,C,22,67,2242,312,594,0.525,0,1,0.0,312,593,0.526,0.525,149,205,0.727,145,479,624,163,53,95,103,190,773,OOR
Eddie House,PG,30,81,1479,249,560,0.445,151,340,0.444,98,220,0.445,0.579,42,53,0.792,11,146,157,92,61,7,55,113,691,OOR
Dwight Howard,C,23,79,2821,560,979,0.572,0,2,0.0,560,977,0.573,0.572,504,849,0.594,336,757,1093,112,77,231,240,270,1624,Candidate
Josh Howard,SF,28,52,1663,353,783,0.451,58,168,0.345,295,615,0.48,0.488,172,220,0.782,59,204,263,83,55,30,89,135,936,OOR
Juwan Howard,SF-PF,35,42,472,75,147,0.51,0,0,0.0,75,147,0.51,0.51,23,34,0.676,30,46,76,26,7,6,26,71,173,OOR
Larry Hughes,SF-SG,30,55,1479,224,557,0.402,75,193,0.389,149,364,0.409,0.469,117,145,0.807,16,143,159,119,72,14,71,96,640,OOR
Kris Humphries,SF,23,29,265,38,90,0.422,0,0,0.0,38,90,0.422,0.422,38,48,0.792,24,46,70,10,8,6,8,31,114,OOR
Lindsey Hunter,PG,38,28,266,27,82,0.329,16,48,0.333,11,34,0.324,0.427,3,5,0.6,2,10,12,37,20,1,19,28,73,OOR
Othello Hunter,PF,22,16,92,11,20,0.55,0,0,0.0,11,20,0.55,0.55,0,5,0.0,9,15,24,1,2,5,2,11,22,OOR
Andre Iguodala,SF,25,82,3269,542,1147,0.473,80,261,0.307,462,886,0.521,0.507,377,521,0.724,92,379,471,434,131,36,222,152,1541,OOR
Zydrunas Ilgauskas,C,33,65,1765,342,724,0.472,15,39,0.385,327,685,0.477,0.483,139,174,0.799,157,333,490,64,28,84,90,183,838,OOR
D.J. Mbenga,C,28,23,181,27,57,0.474,0,1,0.0,27,56,0.482,0.474,7,8,0.875,9,22,31,9,10,24,13,33,61,OOR
Allen Iverson,PG-SG,33,57,2093,348,834,0.417,28,99,0.283,320,735,0.435,0.434,271,347,0.781,30,143,173,283,88,6,146,86,995,OOR
Royal Ivey,SG,27,71,861,69,208,0.332,39,114,0.342,30,94,0.319,0.425,34,43,0.791,19,57,76,43,36,7,23,76,211,OOR
Jarrett Jack,SG,25,82,2716,386,853,0.453,78,221,0.353,308,632,0.487,0.498,224,263,0.852,44,232,276,338,88,17,184,179,1074,OOR
Bobby Jackson,PG,35,71,1484,193,485,0.398,60,197,0.305,133,288,0.462,0.46,86,101,0.851,42,158,200,143,62,4,66,100,532,OOR
Darnell Jackson,PF,23,51,430,37,86,0.43,0,2,0.0,37,84,0.44,0.43,24,35,0.686,32,55,87,8,10,4,14,77,98,OOR
Stephen Jackson,SF,30,59,2339,413,997,0.414,103,305,0.338,310,692,0.448,0.466,294,356,0.826,70,233,303,381,88,31,229,153,1223,OOR
Jerome James,C,33,2,10,3,8,0.375,0,0,0.0,3,8,0.375,0.375,0,0,0.0,1,2,3,0,1,1,1,2,6,OOR
LeBron James,SF,24,81,3054,789,1613,0.489,132,384,0.344,657,1229,0.535,0.53,594,762,0.78,106,507,613,587,137,93,241,139,2304,MVP
Mike James,PG,33,61,1649,197,514,0.383,69,184,0.375,128,330,0.388,0.45,68,82,0.829,25,108,133,201,44,6,94,108,531,OOR
Antawn Jamison,PF,32,81,3096,674,1441,0.468,112,319,0.351,562,1122,0.501,0.507,341,452,0.754,196,525,721,153,95,25,125,218,1801,OOR
Marko Jarić,SG,30,53,605,48,145,0.331,11,28,0.393,37,117,0.316,0.369,29,41,0.707,23,42,65,74,29,11,49,62,136,OOR
Nathan Jawai,PF,22,6,19,1,4,0.25,0,0,0.0,1,4,0.25,0.25,0,0,0.0,1,1,2,0,0,0,2,3,2,OOR
Al Jefferson,C,24,50,1836,485,975,0.497,0,4,0.0,485,971,0.499,0.497,186,252,0.738,172,376,548,79,39,83,92,141,1156,OOR
Dontell Jefferson,SG,25,6,84,11,22,0.5,1,2,0.5,10,20,0.5,0.523,6,9,0.667,1,11,12,9,4,1,6,9,29,OOR
Richard Jefferson,SF,28,82,2939,537,1222,0.439,116,292,0.397,421,930,0.453,0.487,417,518,0.805,57,317,374,199,66,14,165,252,1607,OOR
Jared Jeffries,SF,27,56,1310,120,273,0.44,1,12,0.083,119,261,0.456,0.441,55,90,0.611,128,103,231,80,47,33,65,153,296,OOR
Yi Jianlian,PF,21,61,1421,191,500,0.382,48,140,0.343,143,360,0.397,0.43,95,123,0.772,67,259,326,60,29,36,70,157,525,OOR
Amir Johnson,PF,21,62,911,97,163,0.595,0,0,0.0,97,163,0.595,0.595,23,35,0.657,102,130,232,20,20,60,33,171,217,OOR
Anthony Johnson,PG,34,80,1481,154,381,0.404,52,133,0.391,102,248,0.411,0.472,61,81,0.753,29,118,147,200,46,5,82,111,421,OOR
Joe Johnson,SG,27,79,3124,620,1420,0.437,149,414,0.36,471,1006,0.468,0.489,299,362,0.826,65,281,346,455,84,19,195,176,1688,OOR
Linton Johnson,PF,28,10,55,4,11,0.364,1,2,0.5,3,9,0.333,0.409,0,0,0.0,3,5,8,2,1,0,2,7,9,OOR
Trey Johnson,SG,24,4,14,0,5,0.0,0,0,0.0,0,5,0.0,0.0,4,4,1.0,0,1,1,0,0,0,1,4,4,OOR
Dahntay Jones,SG,28,79,1426,154,336,0.458,11,17,0.647,143,319,0.448,0.475,110,151,0.728,58,110,168,78,49,19,68,199,429,OOR
Damon Jones,PG,32,18,108,11,34,0.324,11,28,0.393,0,6,0.0,0.485,0,0,0.0,0,6,6,7,3,0,6,4,33,OOR
Dwayne Jones,PF,25,6,52,4,7,0.571,0,0,0.0,4,7,0.571,0.571,4,6,0.667,6,6,12,0,0,1,4,6,12,OOR
Fred Jones,SF,29,52,1495,129,317,0.407,54,147,0.367,75,170,0.441,0.492,66,81,0.815,23,103,126,188,53,11,66,112,378,OOR
James Jones,SF,28,40,630,55,149,0.369,33,96,0.344,22,53,0.415,0.48,26,31,0.839,12,50,62,20,12,14,12,58,169,OOR
Solomon Jones,C,24,63,675,67,111,0.604,1,2,0.5,66,109,0.606,0.608,53,74,0.716,52,90,142,15,7,34,27,125,188,OOR
DeAndre Jordan,C,20,53,771,93,147,0.633,0,0,0.0,93,147,0.633,0.633,42,109,0.385,72,165,237,11,11,59,41,96,228,OOR
Chris Kaman,C,26,31,921,161,305,0.528,0,0,0.0,161,305,0.528,0.528,51,75,0.68,75,172,247,46,17,45,84,93,373,OOR
Jason Kapono,SG,27,80,1831,261,604,0.432,98,229,0.428,163,375,0.435,0.513,34,42,0.81,26,137,163,105,22,3,70,144,654,OOR
Jason Kidd,PG,35,81,2886,257,618,0.416,131,323,0.406,126,295,0.427,0.522,86,105,0.819,85,415,500,702,160,39,185,168,731,OOR
Tarence Kinsey,SG,24,50,277,31,69,0.449,7,18,0.389,24,51,0.471,0.5,33,38,0.868,10,28,38,10,12,0,22,34,102,OOR
Andrei Kirilenko,PF,27,67,1831,256,570,0.449,20,73,0.274,236,497,0.475,0.467,244,311,0.785,84,235,319,175,83,77,121,127,776,OOR
Linas Kleiza,SF,24,82,1824,289,646,0.447,87,267,0.326,202,379,0.533,0.515,148,204,0.725,92,235,327,64,31,14,82,155,813,OOR
Brevin Knight,PG,33,74,938,66,189,0.349,0,6,0.0,66,183,0.361,0.349,48,64,0.75,13,75,88,190,68,4,66,98,180,OOR
Kyle Korver,SF,27,78,1874,245,560,0.438,103,267,0.386,142,293,0.485,0.529,112,127,0.882,35,223,258,137,47,30,90,170,705,OOR
Kosta Koufos,C,19,48,565,94,185,0.508,0,0,0.0,94,185,0.508,0.508,36,51,0.706,50,88,138,20,12,31,26,70,224,OOR
Nenad Krstić,C,25,46,1141,191,407,0.469,0,0,0.0,191,407,0.469,0.469,63,79,0.797,85,168,253,29,21,49,45,114,445,OOR
Rob Kurz,PF,23,40,442,51,131,0.389,15,38,0.395,36,93,0.387,0.447,40,50,0.8,33,48,81,20,14,19,16,78,157,OOR
Carl Landry,PF,25,69,1467,240,418,0.574,1,3,0.333,239,415,0.576,0.575,157,193,0.813,124,219,343,39,26,31,68,166,638,OOR
Acie Law,PG,24,55,560,52,139,0.374,9,29,0.31,43,110,0.391,0.406,49,60,0.817,6,52,58,86,11,3,29,43,162,OOR
Courtney Lee,SG,23,77,1939,243,540,0.45,82,203,0.404,161,337,0.478,0.526,78,94,0.83,18,160,178,91,76,14,69,157,646,OOR
David Lee,C,25,81,2824,522,951,0.549,0,3,0.0,522,948,0.551,0.549,249,330,0.755,256,695,951,174,80,22,150,260,1293,OOR
Rashard Lewis,PF,29,79,2859,478,1089,0.439,220,554,0.397,258,535,0.482,0.54,225,269,0.836,92,361,453,205,81,51,158,194,1401,OOR
Shaun Livingston,PG,23,12,231,31,60,0.517,0,0,0.0,31,60,0.517,0.517,9,10,0.9,3,25,28,20,7,2,9,12,71,OOR
Brook Lopez,C,20,82,2501,448,844,0.531,0,2,0.0,448,842,0.532,0.531,172,217,0.793,225,440,665,86,44,151,147,257,1068,OOR
Robin Lopez,C,20,60,614,71,137,0.518,0,1,0.0,71,136,0.522,0.518,47,68,0.691,52,66,118,8,11,41,28,97,189,OOR
Kevin Love,C,20,81,2048,316,688,0.459,2,19,0.105,314,669,0.469,0.461,265,336,0.789,274,460,734,84,35,50,118,205,899,OOR
Kyle Lowry,PG,22,77,1679,189,434,0.435,25,98,0.255,164,336,0.488,0.464,181,226,0.801,26,163,189,275,69,17,117,146,584,OOR
Tyronn Lue,PG,31,44,521,71,162,0.438,27,62,0.435,44,100,0.44,0.522,14,19,0.737,6,40,46,60,8,0,23,54,183,OOR
Mark Madsen,C,33,19,116,3,14,0.214,0,0,0.0,3,14,0.214,0.214,0,4,0.0,10,8,18,4,1,1,3,18,6,OOR
Corey Maggette,PF,29,51,1588,292,634,0.461,24,95,0.253,268,539,0.497,0.479,342,415,0.824,49,233,282,92,44,8,120,192,950,OOR
Jamaal Magloire,C,30,55,709,65,131,0.496,0,0,0.0,65,131,0.496,0.496,29,60,0.483,82,140,222,22,11,25,32,121,159,OOR
Stephon Marbury,PG,31,23,414,38,111,0.342,6,25,0.24,32,86,0.372,0.369,6,13,0.462,2,26,28,75,10,3,37,34,88,OOR
Shawn Marion,SF,30,69,2470,382,788,0.485,10,53,0.189,372,735,0.506,0.491,117,147,0.796,180,409,589,139,88,66,105,132,891,OOR
Sean Marks,C,33,60,838,80,165,0.485,2,10,0.2,78,155,0.503,0.491,30,44,0.682,62,125,187,14,7,33,35,121,192,OOR
Donyell Marshall,PF,35,25,189,33,73,0.452,25,55,0.455,8,18,0.444,0.623,3,6,0.5,6,34,40,15,4,5,6,24,94,OOR
Cartier Martin,SF,24,33,266,28,77,0.364,10,33,0.303,18,44,0.409,0.429,20,25,0.8,7,26,33,13,8,4,9,33,86,OOR
Kenyon Martin,PF,31,66,2111,318,648,0.491,14,38,0.368,304,610,0.498,0.502,119,197,0.604,81,314,395,132,96,74,104,201,769,OOR
Kevin Martin,SG,25,51,1947,341,811,0.42,115,277,0.415,226,534,0.423,0.491,457,527,0.867,29,154,183,138,61,8,146,116,1254,OOR
Desmond Mason,SG,31,39,1064,124,285,0.435,0,3,0.0,124,282,0.44,0.435,46,85,0.541,41,116,157,46,15,30,56,96,294,OOR
Roger Mason,SG,28,82,2496,349,822,0.425,166,394,0.421,183,428,0.428,0.526,105,118,0.89,16,235,251,173,40,12,100,160,969,OOR
Jason Maxiell,C,25,78,1408,184,320,0.575,0,1,0.0,184,319,0.577,0.575,84,158,0.532,169,155,324,24,25,63,45,157,452,OOR
Sean May,PF,24,24,301,39,98,0.398,1,1,1.0,38,97,0.392,0.403,14,20,0.7,20,49,69,10,5,4,26,32,93,OOR
O.J. Mayo,SG,21,82,3120,562,1283,0.438,145,378,0.384,417,905,0.461,0.495,247,281,0.879,56,252,308,262,91,13,226,204,1516,OOR
Luc Mbah a Moute,PF,22,82,2114,227,491,0.462,0,4,0.0,227,487,0.466,0.462,140,192,0.729,189,298,487,87,87,45,100,204,594,OOR
Rashad McCants,SG,24,58,1101,192,488,0.393,63,189,0.333,129,299,0.431,0.458,107,141,0.759,21,89,110,68,47,14,64,103,554,OOR
Antonio McDyess,PF,34,62,1866,268,525,0.51,0,0,0.0,268,525,0.51,0.51,60,86,0.698,185,422,607,83,41,50,51,191,596,OOR
JaVale McGee,C,21,75,1143,191,387,0.494,0,0,0.0,191,387,0.494,0.494,107,162,0.66,120,174,294,23,33,75,61,155,489,OOR
Tracy McGrady,SG,29,35,1181,188,485,0.388,44,117,0.376,144,368,0.391,0.433,125,156,0.801,20,134,154,175,42,15,69,38,545,OOR
Dominic McGuire,SF,23,79,2072,140,324,0.432,2,4,0.5,138,320,0.431,0.435,74,102,0.725,113,315,428,198,62,74,92,153,356,OOR
Josh McRoberts,PF,21,33,279,35,83,0.422,0,10,0.0,35,73,0.479,0.422,10,13,0.769,26,48,74,16,12,16,12,41,80,OOR
Pops Mensah-Bonsu,PF,25,22,283,39,103,0.379,0,2,0.0,39,101,0.386,0.379,33,48,0.688,55,58,113,6,9,5,19,43,111,OOR
Chris Mihm,C,29,18,105,15,40,0.375,0,0,0.0,15,40,0.375,0.375,6,7,0.857,15,19,34,10,1,6,10,23,36,OOR
C.J. Miles,SG,21,72,1623,258,562,0.459,63,179,0.352,195,383,0.509,0.515,78,89,0.876,45,122,167,107,46,15,64,187,657,OOR
Darius Miles,SF,27,34,298,48,99,0.485,1,6,0.167,47,93,0.505,0.49,23,31,0.742,19,38,57,17,11,20,21,32,120,OOR
Darko Miličić,C,23,61,1034,137,266,0.515,0,0,0.0,137,266,0.515,0.515,59,105,0.562,83,181,264,34,22,51,48,134,333,OOR
Andre Miller,PG,32,82,2976,492,1041,0.473,15,53,0.283,477,988,0.483,0.48,338,409,0.826,123,245,368,534,109,14,199,196,1337,OOR
Brad Miller,C,32,70,2100,292,614,0.476,23,56,0.411,269,558,0.482,0.494,224,272,0.824,150,395,545,234,52,36,130,223,831,OOR
Mike Miller,SF,28,73,2356,264,548,0.482,85,225,0.378,179,323,0.554,0.559,109,149,0.732,73,410,483,326,30,31,145,139,722,OOR
Paul Millsap,PF,23,76,2290,400,749,0.534,0,4,0.0,400,745,0.537,0.534,228,326,0.699,251,403,654,138,78,73,129,288,1028,OOR
Yao Ming,C,28,77,2589,566,1032,0.548,1,1,1.0,565,1031,0.548,0.549,381,440,0.866,204,557,761,137,30,150,234,257,1514,OOR
Cuttino Mobley,SG,33,11,365,63,146,0.432,12,35,0.343,51,111,0.459,0.473,13,18,0.722,9,20,29,12,15,2,18,21,151,OOR
Nazr Mohammed,C,31,39,341,41,101,0.406,0,0,0.0,41,101,0.406,0.406,22,40,0.55,35,44,79,8,5,16,23,63,104,OOR
Jamario Moon,SF,28,80,2068,222,474,0.468,65,183,0.355,157,291,0.54,0.537,68,80,0.85,58,307,365,95,86,60,43,133,577,OOR
Mikki Moore,PF-C,33,70,1202,114,206,0.553,0,0,0.0,114,206,0.553,0.553,48,61,0.787,76,182,258,53,17,19,48,208,276,OOR
Randolph Morris,C,23,23,89,7,17,0.412,0,0,0.0,7,17,0.412,0.412,4,4,1.0,4,16,20,2,2,1,7,25,18,OOR
Adam Morrison,SF,24,52,711,80,223,0.359,32,96,0.333,48,127,0.378,0.43,17,23,0.739,18,62,80,41,9,4,32,77,209,OOR
Anthony Morrow,SG,23,67,1515,255,534,0.478,86,184,0.467,169,350,0.483,0.558,80,92,0.87,78,121,199,80,36,12,52,130,676,OOR
Troy Murphy,PF,28,73,2482,364,767,0.475,161,358,0.45,203,409,0.496,0.58,152,184,0.826,146,715,861,172,58,34,114,226,1041,OOR
Ronald Murray,SG,29,80,1975,355,795,0.447,87,242,0.36,268,553,0.485,0.501,177,233,0.76,22,146,168,158,88,17,128,173,974,OOR
Dikembe Mutombo,C,42,9,96,5,13,0.385,0,0,0.0,5,13,0.385,0.385,6,9,0.667,12,21,33,0,0,11,6,11,16,OOR
Eduardo Nájera,PF,32,27,319,33,74,0.446,5,25,0.2,28,49,0.571,0.48,8,22,0.364,17,50,67,19,10,4,18,50,79,OOR
Steve Nash,PG,34,74,2484,428,851,0.503,108,246,0.439,320,605,0.529,0.566,196,210,0.933,19,204,223,717,55,10,248,108,1160,OOR
DeMarcus Nelson,PG,23,13,171,24,54,0.444,0,3,0.0,24,51,0.471,0.444,5,14,0.357,6,18,24,13,9,2,15,24,53,OOR
Jameer Nelson,PG,26,42,1309,267,531,0.503,82,181,0.453,185,350,0.529,0.58,86,97,0.887,20,125,145,226,51,3,83,123,702,OOR
Rasho Nesterović,C,32,70,1214,224,437,0.513,0,1,0.0,224,436,0.514,0.513,25,32,0.781,93,147,240,109,30,38,63,171,473,OOR
Demetris Nichols,SF,24,4,14,3,9,0.333,0,2,0.0,3,7,0.429,0.333,1,2,0.5,0,2,2,1,0,1,0,1,7,OOR
Joakim Noah,C,23,80,1938,207,372,0.556,0,1,0.0,207,371,0.558,0.556,123,182,0.676,244,362,606,106,49,110,82,238,537,OOR
Andrés Nocioni,PF-SF,29,76,1991,299,701,0.427,124,311,0.399,175,390,0.449,0.515,145,183,0.792,54,307,361,102,39,33,113,261,867,OOR
Steve Novak,PF,25,71,1161,176,396,0.444,119,286,0.416,57,110,0.518,0.595,21,23,0.913,19,106,125,40,20,5,23,71,492,OOR
Dirk Nowitzki,PF,30,81,3050,774,1616,0.479,61,170,0.359,713,1446,0.493,0.498,485,545,0.89,88,593,681,197,61,63,157,176,2094,OOR
Patrick O'Bryant,C,22,39,255,45,84,0.536,0,2,0.0,45,82,0.549,0.536,11,20,0.55,13,53,66,11,6,19,22,61,101,OOR
Jermaine O'Neal,C,30,68,2027,365,770,0.474,0,1,0.0,365,769,0.475,0.474,175,222,0.788,126,307,433,122,29,136,144,211,905,OOR
Shaquille O'Neal,C,36,75,2252,512,841,0.609,0,1,0.0,512,840,0.61,0.609,309,519,0.595,187,446,633,126,49,108,168,253,1333,OOR
Fabricio Oberto,C,33,54,677,61,104,0.587,0,1,0.0,61,103,0.592,0.587,20,35,0.571,65,77,142,59,7,11,38,95,142,OOR
Greg Oden,C,21,61,1314,198,351,0.564,0,0,0.0,198,351,0.564,0.564,144,226,0.637,169,255,424,31,25,69,87,238,540,OOR
Lamar Odom,PF,29,78,2316,346,703,0.492,33,103,0.32,313,600,0.522,0.516,160,257,0.623,176,461,637,204,77,98,138,235,885,OOR
Emeka Okafor,C,26,82,2691,433,772,0.561,0,0,0.0,433,772,0.561,0.561,219,369,0.593,275,552,827,53,48,136,144,247,1085,OOR
Mehmet Okur,C,29,72,2409,431,888,0.485,90,202,0.446,341,686,0.497,0.536,273,334,0.817,124,433,557,120,54,53,132,219,1225,OOR
Kevin Ollie,PG,36,50,850,61,150,0.407,0,1,0.0,61,149,0.409,0.407,80,96,0.833,13,62,75,117,19,4,34,79,202,OOR
Travis Outlaw,SF,24,81,2246,385,850,0.453,89,236,0.377,296,614,0.482,0.505,175,242,0.723,70,261,331,83,47,57,94,168,1034,OOR
Zaza Pachulia,C,24,77,1473,159,320,0.497,0,3,0.0,159,317,0.502,0.497,163,230,0.709,173,263,436,57,35,26,91,208,481,OOR
Anthony Parker,SG,33,80,2637,321,754,0.426,94,241,0.39,227,513,0.442,0.488,121,145,0.834,45,272,317,269,100,15,114,145,857,OOR
Tony Parker,PG,26,72,2456,639,1263,0.506,19,65,0.292,620,1198,0.518,0.513,284,363,0.782,27,196,223,496,67,4,186,110,1581,OOR
Chris Paul,PG,23,78,3002,631,1255,0.503,64,176,0.364,567,1079,0.525,0.528,455,524,0.868,69,363,432,861,216,10,231,212,1781,Candidate
Sasha Pavlović,SF,25,66,1053,116,275,0.422,48,117,0.41,68,158,0.43,0.509,25,54,0.463,31,96,127,72,22,16,48,122,305,OOR
Oleksiy Pecherov,C,23,32,277,39,101,0.386,14,43,0.326,25,58,0.431,0.455,24,29,0.828,35,41,76,2,6,3,10,34,116,OOR
Kendrick Perkins,C,24,76,2253,276,478,0.577,0,2,0.0,276,476,0.58,0.577,96,160,0.6,204,415,619,96,22,150,165,253,648,OOR
Morris Peterson,SG,31,43,515,73,183,0.399,33,85,0.388,40,98,0.408,0.489,12,19,0.632,13,71,84,16,15,2,15,51,191,OOR
Johan Petro,C,23,49,559,73,176,0.415,0,2,0.0,73,174,0.42,0.415,16,29,0.552,42,116,158,16,19,15,28,107,162,OOR
Paul Pierce,SF,31,81,3035,540,1181,0.457,119,304,0.391,421,877,0.48,0.508,459,553,0.83,56,401,457,294,80,27,228,215,1658,OOR
Mickaël Piétrus,SG,26,54,1329,176,426,0.413,80,223,0.359,96,203,0.473,0.507,78,110,0.709,44,132,176,65,31,24,56,126,510,OOR
James Posey,SG,32,75,2140,216,524,0.412,116,314,0.369,100,210,0.476,0.523,120,146,0.822,38,324,362,82,58,21,79,216,668,OOR
Leon Powe,PF,25,70,1227,177,338,0.524,0,0,0.0,177,338,0.524,0.524,184,267,0.689,145,200,345,46,24,38,76,192,538,OOR
Josh Powell,PF,26,60,703,106,239,0.444,0,0,0.0,106,239,0.444,0.444,38,50,0.76,71,105,176,27,9,17,51,98,250,OOR
Ronnie Price,PG,25,52,738,77,203,0.379,19,61,0.311,58,142,0.408,0.426,34,45,0.756,12,57,69,108,39,5,61,74,207,OOR
Tayshaun Prince,SF,28,82,3057,459,1020,0.45,56,141,0.397,403,879,0.458,0.477,189,243,0.778,128,348,476,253,44,51,101,104,1163,OOR
Gabe Pruitt,SG,22,47,366,31,101,0.307,14,48,0.292,17,53,0.321,0.376,17,21,0.81,9,34,43,39,15,3,19,34,93,OOR
Joel Przybilla,C,29,82,1952,168,269,0.625,0,1,0.0,168,268,0.627,0.625,112,169,0.663,204,513,717,27,34,97,78,215,448,OOR
Chris Quinn,PG,25,66,962,118,289,0.408,56,137,0.409,62,152,0.408,0.505,47,58,0.81,8,67,75,132,24,2,33,79,339,OOR
Vladimir Radmanović,SF,28,78,1445,196,466,0.421,105,262,0.401,91,204,0.446,0.533,43,58,0.741,45,177,222,81,46,15,98,111,540,OOR
Anthony Randolph,PF,19,63,1129,199,431,0.462,0,4,0.0,199,427,0.466,0.462,101,141,0.716,128,235,363,49,42,74,80,141,499,OOR
Shavlik Randolph,PF,25,10,37,8,13,0.615,1,1,1.0,7,12,0.583,0.654,1,4,0.25,10,8,18,0,0,1,6,4,18,OOR
Zach Randolph,PF-C,27,50,1757,415,873,0.475,32,97,0.33,383,776,0.494,0.494,179,244,0.734,157,347,504,103,43,16,114,133,1041,OOR
Theo Ratliff,C,35,46,579,34,64,0.531,0,0,0.0,34,64,0.531,0.531,21,35,0.6,46,82,128,9,17,47,14,77,89,OOR
Michael Redd,SG,29,33,1203,249,547,0.455,70,191,0.366,179,356,0.503,0.519,131,161,0.814,24,83,107,88,35,2,53,45,699,OOR
J.J. Redick,SG,24,64,1111,117,299,0.391,67,179,0.374,50,120,0.417,0.503,81,93,0.871,8,101,109,73,21,1,54,72,382,OOR
Jason Richardson,SG,28,72,2410,465,974,0.477,129,325,0.397,336,649,0.518,0.544,153,199,0.769,77,242,319,146,76,28,95,146,1212,OOR
Jeremy Richardson,SF,24,12,93,14,49,0.286,6,17,0.353,8,32,0.25,0.347,3,6,0.5,1,13,14,3,0,0,3,6,37,OOR
Quentin Richardson,SG,28,72,1894,262,667,0.393,120,329,0.365,142,338,0.42,0.483,89,117,0.761,71,248,319,117,47,7,74,132,733,OOR
Luke Ridnour,PG,27,72,2033,250,621,0.403,55,157,0.35,195,464,0.42,0.447,133,153,0.869,33,185,218,365,92,16,128,200,688,OOR
Anthony Roberson,PG,25,29,276,44,120,0.367,26,81,0.321,18,39,0.462,0.475,5,5,1.0,6,16,22,20,10,1,8,18,119,OOR
Nate Robinson,PG,24,74,2209,449,1028,0.437,125,385,0.325,324,643,0.504,0.498,249,296,0.841,98,192,290,301,95,6,139,206,1272,OOR
Sergio Rodríguez,PG,22,80,1225,129,329,0.392,37,114,0.325,92,215,0.428,0.448,61,77,0.792,43,87,130,286,54,2,119,133,356,OOR
Rajon Rondo,PG,22,80,2642,383,759,0.505,15,48,0.313,368,711,0.518,0.514,172,268,0.642,100,316,416,659,149,11,209,193,953,OOR
Derrick Rose,PG,20,81,3000,574,1208,0.475,16,72,0.222,558,1136,0.491,0.482,197,250,0.788,96,221,317,512,66,18,202,125,1361,OOR
Malik Rose,PF,34,38,470,45,131,0.344,0,7,0.0,45,124,0.363,0.344,40,51,0.784,17,79,96,36,10,3,36,72,130,OOR
Quinton Ross,SF,27,68,1164,99,259,0.382,33,88,0.375,66,171,0.386,0.446,34,42,0.81,29,97,126,47,32,14,36,114,265,OOR
Brandon Roy,SG,24,78,2903,633,1318,0.48,83,220,0.377,550,1098,0.501,0.512,416,505,0.824,104,266,370,400,88,22,152,127,1765,OOR
Michael Ruffin,PF,32,11,35,2,7,0.286,0,0,0.0,2,7,0.286,0.286,2,2,1.0,6,5,11,0,3,1,2,7,6,OOR
Brandon Rush,SG,23,75,1803,243,575,0.423,78,209,0.373,165,366,0.451,0.49,46,66,0.697,34,199,233,66,38,37,75,128,610,OOR
Kareem Rush,SG,28,25,199,20,58,0.345,10,33,0.303,10,25,0.4,0.431,4,4,1.0,0,15,15,15,5,1,10,10,54,OOR
John Salmons,SF,29,79,2959,516,1093,0.472,126,302,0.417,390,791,0.493,0.53,288,347,0.83,59,274,333,249,83,24,165,182,1446,OOR
Cheikh Samb,C,24,18,83,6,32,0.188,0,3,0.0,6,29,0.207,0.188,3,7,0.429,10,14,24,1,3,10,3,7,15,OOR
Brian Scalabrine,C,30,39,504,48,114,0.421,24,61,0.393,24,53,0.453,0.526,16,18,0.889,7,43,50,18,7,10,12,73,136,OOR
Luis Scola,PF,28,82,2488,424,799,0.531,0,3,0.0,424,796,0.533,0.531,196,258,0.76,200,520,720,123,68,11,123,261,1044,OOR
Thabo Sefolosha,SF-SG,24,66,1453,152,357,0.426,24,87,0.276,128,270,0.474,0.459,61,73,0.836,54,188,242,111,75,45,64,104,389,OOR
Mouhamed Sene,C,22,6,29,6,9,0.667,0,0,0.0,6,9,0.667,0.667,8,10,0.8,5,9,14,0,1,3,4,2,20,OOR
Ramon Sessions,PG,22,79,2173,345,775,0.445,6,34,0.176,339,741,0.457,0.449,281,354,0.794,64,205,269,452,83,7,152,158,977,OOR
Walter Sharpe,PF,22,8,20,4,11,0.364,0,2,0.0,4,9,0.444,0.364,0,2,0.0,0,3,3,0,0,2,0,3,8,OOR
Bobby Simmons,SF,28,71,1729,198,441,0.449,117,262,0.447,81,179,0.453,0.582,43,58,0.741,72,205,277,92,50,10,62,186,556,OOR
Cedric Simmons,PF,23,18,84,11,25,0.44,0,0,0.0,11,25,0.44,0.44,7,16,0.438,5,11,16,2,1,4,2,8,29,OOR
Courtney Sims,C,25,2,13,3,6,0.5,0,0,0.0,3,6,0.5,0.5,0,0,0.0,2,2,4,0,0,0,1,1,6,OOR
Sean Singletary,PG,23,37,303,31,85,0.365,10,25,0.4,21,60,0.35,0.424,18,21,0.857,10,25,35,29,11,0,23,45,90,OOR
James Singleton,PF,27,62,884,117,221,0.529,13,40,0.325,104,181,0.575,0.559,67,78,0.859,89,161,250,17,26,28,36,110,314,OOR
Brian Skinner,PF,32,51,843,92,205,0.449,0,2,0.0,92,203,0.453,0.449,30,47,0.638,72,131,203,27,17,52,43,94,214,OOR
Craig Smith,PF,25,74,1460,289,514,0.562,0,1,0.0,289,513,0.563,0.562,168,248,0.677,98,186,284,79,31,19,105,184,746,OOR
J.R. Smith,SG,23,81,2245,424,950,0.446,180,453,0.397,244,497,0.491,0.541,205,272,0.754,43,254,297,227,78,14,150,190,1233,OOR
Joe Smith,C,33,57,1102,156,333,0.468,3,7,0.429,153,326,0.469,0.473,59,82,0.72,89,174,263,41,17,40,25,122,374,OOR
Josh Smith,PF,23,69,2421,418,849,0.492,26,87,0.299,392,762,0.514,0.508,211,359,0.588,134,364,498,169,94,111,161,184,1073,OOR
Will Solomon,PG,30,53,712,105,245,0.429,28,86,0.326,77,159,0.484,0.486,25,34,0.735,12,52,64,133,27,4,54,71,263,OOR
Darius Songaila,C,30,77,1521,243,457,0.532,0,1,0.0,243,456,0.533,0.532,80,90,0.889,75,152,227,94,64,20,74,200,566,OOR
Marreese Speights,C,21,79,1263,252,502,0.502,2,8,0.25,250,494,0.506,0.504,102,132,0.773,123,170,293,30,27,56,46,181,608,OOR
Jerry Stackhouse,SG,34,10,162,16,60,0.267,3,19,0.158,13,41,0.317,0.292,7,7,1.0,5,12,17,12,4,1,9,6,42,OOR
DeShawn Stevenson,SG,27,32,886,72,231,0.312,35,129,0.271,37,102,0.363,0.387,32,60,0.533,11,65,76,98,21,2,32,43,211,OOR
Peja Stojaković,SF,31,61,2089,287,719,0.399,145,384,0.378,142,335,0.424,0.5,93,104,0.894,44,220,264,75,52,3,51,101,812,OOR
Amar'e Stoudemire,PF,26,53,1948,404,749,0.539,3,7,0.429,401,742,0.54,0.541,323,387,0.835,116,314,430,104,49,57,150,163,1134,OOR
Rodney Stuckey,PG,22,79,2517,401,913,0.439,23,78,0.295,378,835,0.453,0.452,233,290,0.803,69,206,275,387,78,11,173,217,1058,OOR
Robert Swift,C,23,26,343,37,71,0.521,0,0,0.0,37,71,0.521,0.521,12,16,0.75,21,68,89,9,5,17,8,50,86,OOR
Stromile Swift,PF,29,19,185,24,56,0.429,1,1,1.0,23,55,0.418,0.438,13,26,0.5,16,30,46,3,4,8,16,40,62,OOR
Wally Szczerbiak,SF,31,74,1527,179,398,0.45,69,168,0.411,110,230,0.478,0.536,90,106,0.849,43,189,232,82,28,10,55,130,517,OOR
Mike Taylor,PG,23,51,771,110,267,0.412,13,40,0.325,97,227,0.427,0.436,56,81,0.691,22,65,87,106,36,0,73,84,289,OOR
Sebastian Telfair,PG,23,75,2095,267,697,0.383,73,211,0.346,194,486,0.399,0.435,131,160,0.819,32,95,127,343,73,12,146,184,738,OOR
Jason Terry,SG,31,74,2491,541,1168,0.463,167,456,0.366,374,712,0.525,0.535,198,225,0.88,39,138,177,251,97,20,119,141,1447,OOR
Etan Thomas,C,30,26,306,32,66,0.485,0,0,0.0,32,66,0.485,0.485,16,23,0.696,25,41,66,6,3,18,18,35,80,OOR
Kenny Thomas,PF,31,8,62,3,8,0.375,0,0,0.0,3,8,0.375,0.375,0,0,0.0,4,11,15,1,6,1,1,9,6,OOR
Kurt Thomas,PF,36,79,1404,153,304,0.503,0,2,0.0,153,302,0.507,0.503,37,45,0.822,134,271,405,66,34,58,42,170,343,OOR
Tim Thomas,PF,31,64,1247,189,438,0.432,78,189,0.413,111,249,0.446,0.521,89,121,0.736,42,159,201,68,31,11,70,144,545,OOR
Tyrus Thomas,PF,22,79,2175,308,683,0.451,3,9,0.333,305,674,0.453,0.453,238,304,0.783,148,360,508,77,91,151,129,220,857,OOR
Jason Thompson,PF,22,82,2303,356,717,0.497,0,8,0.0,356,709,0.502,0.497,198,286,0.692,234,372,606,93,46,59,146,314,910,OOR
Al Thornton,SF,25,71,2654,469,1051,0.446,20,79,0.253,449,972,0.462,0.456,236,313,0.754,122,246,368,103,59,62,130,227,1194,OOR
Anthony Tolliver,PF,23,19,208,19,65,0.292,9,41,0.22,10,24,0.417,0.362,5,10,0.5,12,29,41,17,5,1,7,16,52,OOR
Alando Tucker,SG,24,30,282,52,121,0.43,8,23,0.348,44,98,0.449,0.463,26,33,0.788,19,12,31,12,5,1,14,14,138,OOR
Ronny Turiaf,C,26,79,1696,186,366,0.508,0,3,0.0,186,363,0.512,0.508,98,124,0.79,88,272,360,166,34,168,70,243,470,OOR
Hedo Türkoğlu,SF,29,77,2815,423,1025,0.413,134,376,0.356,289,649,0.445,0.478,314,389,0.807,45,365,410,375,64,19,204,218,1294,OOR
Ime Udoka,SF,31,67,1035,110,287,0.383,41,125,0.328,69,162,0.426,0.455,28,46,0.609,28,159,187,54,36,12,38,86,289,OOR
Beno Udrih,PG,26,73,2270,321,696,0.461,35,113,0.31,286,583,0.491,0.486,123,150,0.82,46,174,220,342,81,12,158,192,800,OOR
Roko Ukić,PG,24,72,890,123,324,0.38,11,62,0.177,112,262,0.427,0.397,44,60,0.733,27,48,75,153,30,2,60,77,301,OOR
Anderson Varejão,PF,26,81,2306,270,504,0.536,0,2,0.0,270,502,0.538,0.536,154,250,0.616,166,415,581,81,75,66,80,239,694,OOR
Jacque Vaughn,PG,33,30,292,24,75,0.32,1,1,1.0,23,74,0.311,0.327,16,18,0.889,4,18,22,55,6,0,15,26,65,OOR
Charlie Villanueva,PF,24,78,2095,487,1089,0.447,89,258,0.345,398,831,0.479,0.488,201,240,0.838,154,366,520,137,50,56,138,254,1264,OOR
Jake Voskuhl,C,31,38,240,12,45,0.267,0,0,0.0,12,45,0.267,0.267,11,14,0.786,21,38,59,8,3,4,17,60,35,OOR
Sasha Vujačić,SG,24,80,1293,155,401,0.387,81,223,0.363,74,178,0.416,0.488,70,76,0.921,19,116,135,113,77,7,35,154,461,OOR
Dwyane Wade,SG,27,79,3048,854,1739,0.491,88,278,0.317,766,1461,0.524,0.516,590,771,0.765,89,309,398,589,173,106,272,178,2386,Candidate
Von Wafer,SG,23,63,1225,229,512,0.447,64,164,0.39,165,348,0.474,0.51,88,117,0.752,19,94,113,71,40,8,59,71,610,OOR
Henry Walker,SF,21,29,216,36,58,0.621,0,1,0.0,36,57,0.632,0.621,16,23,0.696,8,21,29,13,6,2,18,51,88,OOR
Ben Wallace,PF,34,56,1314,69,155,0.445,0,0,0.0,69,155,0.445,0.445,27,64,0.422,136,226,362,44,48,75,34,82,165,OOR
Gerald Wallace,SF,26,71,2669,389,811,0.48,39,131,0.298,350,680,0.515,0.504,365,454,0.804,112,441,553,189,121,67,148,210,1182,OOR
Rasheed Wallace,C,34,66,2123,302,720,0.419,113,319,0.354,189,401,0.471,0.498,78,101,0.772,56,434,490,91,62,86,59,197,795,OOR
Luke Walton,SF,28,65,1166,134,307,0.436,17,57,0.298,117,250,0.468,0.464,41,57,0.719,55,125,180,177,32,10,69,105,326,OOR
Hakim Warrick,PF,26,82,2029,340,693,0.491,5,23,0.217,335,670,0.5,0.494,266,374,0.711,129,277,406,66,48,39,98,170,951,OOR
C.J. Watson,PG,24,77,1883,257,562,0.457,48,120,0.4,209,442,0.473,0.5,168,193,0.87,39,153,192,206,96,4,92,137,730,OOR
Earl Watson,PG,29,68,1776,174,453,0.384,20,85,0.235,154,368,0.418,0.406,80,106,0.755,36,147,183,391,50,11,156,137,448,OOR
Kyle Weaver,SG,22,56,1166,113,246,0.459,32,93,0.344,81,153,0.529,0.524,41,58,0.707,31,99,130,101,47,25,69,81,299,OOR
Martell Webster,SF,22,1,5,0,1,0.0,0,1,0.0,0,0,0.0,0.0,0,0,0.0,0,0,0,0,0,0,0,0,0,OOR
Sonny Weems,SG,22,12,55,8,25,0.32,0,3,0.0,8,22,0.364,0.32,3,8,0.375,0,4,4,3,1,0,6,8,19,OOR
David West,PF,28,76,2982,610,1292,0.472,6,25,0.24,604,1267,0.477,0.474,367,415,0.884,160,486,646,173,49,68,163,207,1593,OOR
Delonte West,SG,25,64,2152,285,624,0.457,91,228,0.399,194,396,0.49,0.53,90,108,0.833,31,172,203,226,94,13,92,125,751,OOR
Mario West,SG,24,53,269,14,34,0.412,1,1,1.0,13,33,0.394,0.426,14,30,0.467,24,32,56,19,18,4,13,35,43,OOR
Russell Westbrook,PG,20,82,2668,436,1095,0.398,35,129,0.271,401,966,0.415,0.414,349,428,0.815,178,221,399,435,110,16,274,191,1256,OOR
D.J. White,PF,22,7,130,26,50,0.52,0,0,0.0,26,50,0.52,0.52,10,13,0.769,10,22,32,6,3,5,3,10,62,OOR
James White,SF,26,4,11,3,5,0.6,1,2,0.5,2,3,0.667,0.7,0,0,0.0,0,0,0,1,1,1,3,2,7,OOR
Chris Wilcox,C,26,62,1049,184,370,0.497,0,4,0.0,184,366,0.503,0.497,79,140,0.564,96,181,277,47,26,16,75,137,447,OOR
Damien Wilkins,SG,29,41,636,77,213,0.362,27,72,0.375,50,141,0.355,0.425,37,46,0.804,20,50,70,37,22,7,37,55,218,OOR
Deron Williams,PG,24,68,2505,463,984,0.471,70,226,0.31,393,758,0.518,0.506,326,384,0.849,24,171,195,725,73,20,228,134,1322,OOR
Jawad Williams,SF,25,10,20,5,12,0.417,2,6,0.333,3,6,0.5,0.5,0,0,0.0,1,1,2,0,1,0,1,2,12,OOR
Lou Williams,SG,22,81,1919,336,844,0.398,63,220,0.286,273,624,0.438,0.435,304,385,0.79,36,129,165,242,85,14,151,128,1039,OOR
Marcus Williams,PG,23,9,54,4,17,0.235,2,6,0.333,2,11,0.182,0.294,2,6,0.333,0,4,4,13,1,1,4,6,12,OOR
Marcus Williams,PF,22,2,3,2,2,1.0,0,0,0.0,2,2,1.0,1.0,0,0,0.0,0,0,0,0,0,0,0,1,4,OOR
Marvin Williams,SF,22,61,2093,285,622,0.458,55,155,0.355,230,467,0.493,0.502,220,273,0.806,110,272,382,81,57,39,70,127,845,OOR
Mo Williams,PG,26,81,2834,526,1126,0.467,183,420,0.436,343,706,0.486,0.548,208,228,0.912,47,232,279,329,69,9,179,215,1443,OOR
Sean Williams,PF,22,33,366,30,72,0.417,0,0,0.0,30,72,0.417,0.417,20,32,0.625,34,45,79,13,7,29,20,72,80,OOR
Shawne Williams,SF,22,15,170,16,56,0.286,1,17,0.059,15,39,0.385,0.295,9,11,0.818,19,27,46,2,2,9,5,19,42,OOR
Shelden Williams,PF,25,45,512,70,157,0.446,0,2,0.0,70,155,0.452,0.446,46,63,0.73,49,104,153,12,22,18,34,64,186,OOR
Metta World Peace,SF,29,69,2452,416,1037,0.401,153,383,0.399,263,654,0.402,0.475,196,262,0.748,65,294,359,229,105,24,140,155,1181,OOR
Antoine Wright,SF,24,65,1552,179,431,0.415,45,149,0.302,134,282,0.475,0.468,71,95,0.747,31,105,136,77,46,27,54,172,474,OOR
Brandan Wright,PF,21,39,688,130,246,0.528,0,4,0.0,130,242,0.537,0.528,63,85,0.741,62,95,157,21,22,37,23,74,323,OOR
Dorell Wright,SF,23,6,73,8,20,0.4,0,0,0.0,8,20,0.4,0.4,2,6,0.333,2,18,20,2,2,0,6,8,18,OOR
Julian Wright,SF,21,54,772,109,234,0.466,2,21,0.095,107,213,0.502,0.47,17,30,0.567,46,106,152,43,35,19,43,49,237,OOR
Lorenzen Wright,C,33,17,125,10,27,0.37,0,0,0.0,10,27,0.37,0.37,3,8,0.375,7,18,25,3,4,5,9,17,23,OOR
Nick Young,SG,23,82,1837,336,756,0.444,56,164,0.341,280,592,0.473,0.481,164,193,0.85,31,119,150,95,39,20,92,140,892,OOR
Thaddeus Young,PF,20,75,2580,475,960,0.495,56,164,0.341,419,796,0.526,0.524,139,189,0.735,139,238,377,86,100,23,118,165,1145,OOR
Sun Yue,SG,23,10,28,3,11,0.273,0,6,0.0,3,5,0.6,0.273,0,0,0.0,0,0,0,2,1,1,3,10,6,OOR
