Player,Pos,Age,G,MP,FG,FGA,FG%,3P,3PA,3P%,2P,2PA,2P%,eFG%,FT,FTA,FT%,ORB,DRB,TRB,AST,STL,BLK,TOV,PF,PTS,Status
Quincy Acy,PF,24,68,1287,152,331,0.459,18,60,0.3,134,271,0.494,0.486,76,97,0.784,79,222,301,68,27,22,60,147,398,OOR
Jordan Adams,SG,20,30,248,35,86,0.407,10,25,0.4,25,61,0.41,0.465,14,23,0.609,9,19,28,16,16,7,14,24,94,OOR
Steven Adams,C,21,70,1771,217,399,0.544,0,2,0.0,217,397,0.547,0.544,103,205,0.502,199,324,523,66,38,86,99,222,537,OOR
Jeff Adrien,PF,28,17,215,19,44,0.432,0,0,0.0,19,44,0.432,0.432,22,38,0.579,23,54,77,15,4,9,9,30,60,OOR
Arron Afflalo,SG,29,78,2502,375,884,0.424,118,333,0.354,257,551,0.466,0.491,167,198,0.843,27,220,247,129,41,7,116,167,1035,OOR
Alexis Ajinça,C,26,68,957,181,329,0.55,0,0,0.0,181,329,0.55,0.55,81,99,0.818,104,211,315,47,21,51,69,151,443,OOR
Furkan Aldemir,PF,23,41,540,40,78,0.513,0,5,0.0,40,73,0.548,0.513,13,27,0.481,78,98,176,28,17,16,17,96,93,OOR
Cole Aldrich,C,26,61,976,144,301,0.478,0,0,0.0,144,301,0.478,0.478,50,64,0.781,101,237,338,75,37,65,59,122,338,OOR
LaMarcus Aldridge,PF,29,71,2512,659,1415,0.466,37,105,0.352,622,1310,0.475,0.479,306,362,0.845,177,549,726,124,48,68,122,125,1661,OOR
Lavoy Allen,C,25,63,1070,141,299,0.472,0,0,0.0,141,299,0.472,0.472,33,47,0.702,123,200,323,73,15,42,40,102,315,OOR
Tony Allen,SG,33,63,1648,225,455,0.495,10,29,0.345,215,426,0.505,0.505,79,126,0.627,103,177,280,86,129,30,86,166,539,OOR
Al-Farouq Aminu,SF,24,74,1366,147,357,0.412,34,124,0.274,113,233,0.485,0.459,84,118,0.712,114,228,342,59,70,62,55,137,412,OOR
Lou Amundson,PF,32,53,937,109,255,0.427,0,1,0.0,109,254,0.429,0.427,41,87,0.471,94,174,268,70,22,52,62,126,259,OOR
Chris Andersen,C,36,60,1132,120,207,0.58,4,13,0.308,116,194,0.598,0.589,76,114,0.667,76,223,299,43,26,61,40,88,320,OOR
Alan Anderson,SG,32,74,1744,195,440,0.443,73,210,0.348,122,230,0.53,0.526,82,101,0.812,31,173,204,83,56,5,60,148,545,OOR
Kyle Anderson,SF,21,33,358,31,89,0.348,3,11,0.273,28,78,0.359,0.365,9,14,0.643,5,67,72,28,15,7,10,28,74,OOR
Ryan Anderson,PF,26,61,1675,291,729,0.399,122,359,0.34,169,370,0.457,0.483,129,151,0.854,108,187,295,55,33,20,62,113,833,OOR
Giannis Antetokounmpo,SG,20,81,2541,383,780,0.491,7,44,0.159,376,736,0.511,0.496,257,347,0.741,100,442,542,207,73,85,173,254,1030,OOR
Carmelo Anthony,SF,30,40,1428,358,806,0.444,61,179,0.341,297,627,0.474,0.482,189,237,0.797,72,192,264,122,40,17,89,87,966,OOR
Joel Anthony,C,32,49,406,36,62,0.581,0,0,0.0,36,62,0.581,0.581,15,22,0.682,32,61,93,5,12,49,12,55,87,OOR
Pero Antić,C,32,63,1037,108,296,0.365,52,173,0.301,56,123,0.455,0.453,88,123,0.715,58,131,189,49,18,14,49,132,356,OOR
Trevor Ariza,SF,29,82,2930,366,910,0.402,194,555,0.35,172,355,0.485,0.509,122,143,0.853,77,382,459,209,152,17,141,186,1048,OOR
Darrell Arthur,PF,26,58,988,155,384,0.404,26,110,0.236,129,274,0.471,0.438,46,59,0.78,53,118,171,57,48,26,47,146,382,OOR
Ömer Aşık,C,28,76,1982,213,412,0.517,0,0,0.0,213,412,0.517,0.517,131,225,0.582,244,504,748,72,29,54,95,144,557,OOR
D.J. Augustin,PG,27,82,1964,258,647,0.399,83,246,0.337,175,401,0.436,0.463,178,205,0.868,20,141,161,353,49,3,145,93,777,OOR
Jeff Ayres,PF,27,51,383,55,95,0.579,0,0,0.0,55,95,0.579,0.579,27,36,0.75,37,80,117,14,8,8,26,60,137,OOR
Luke Babbitt,SF,25,63,830,92,192,0.479,59,115,0.513,33,77,0.429,0.633,13,19,0.684,12,99,111,24,17,11,26,63,256,OOR
Cameron Bairstow,PF,24,18,64,3,14,0.214,0,0,0.0,3,14,0.214,0.214,4,5,0.8,6,2,8,1,2,1,3,8,10,OOR
Leandro Barbosa,SG,32,66,982,183,386,0.474,43,112,0.384,140,274,0.511,0.53,58,74,0.784,23,68,91,99,41,8,44,87,467,OOR
J.J. Barea,PG,30,77,1362,225,536,0.42,54,167,0.323,171,369,0.463,0.47,76,94,0.809,23,111,134,263,33,1,70,104,580,OOR
Andrea Bargnani,C,29,29,785,164,361,0.454,15,41,0.366,149,320,0.466,0.475,87,107,0.813,32,95,127,46,2,27,42,53,430,OOR
Harrison Barnes,SF,22,82,2318,316,656,0.482,87,215,0.405,229,441,0.519,0.548,108,150,0.72,117,336,453,116,61,19,71,146,827,OOR
Matt Barnes,SF,34,76,2271,277,624,0.444,136,376,0.362,141,248,0.569,0.553,74,95,0.779,51,251,302,114,67,50,87,240,764,OOR
Earl Barron,C,33,16,143,12,39,0.308,2,4,0.5,10,35,0.286,0.333,6,12,0.5,14,14,28,5,4,2,5,26,32,OOR
Will Barton,SG,24,58,983,150,353,0.425,23,85,0.271,127,268,0.474,0.458,74,94,0.787,26,136,162,81,48,19,61,70,397,OOR
Brandon Bass,PF,29,82,1929,344,683,0.504,9,32,0.281,335,651,0.515,0.51,169,214,0.79,139,259,398,104,41,32,83,140,866,OOR
Nicolas Batum,SF,26,71,2380,240,600,0.4,100,309,0.324,140,291,0.481,0.483,84,98,0.857,62,354,416,341,78,40,132,106,664,OOR
Jerryd Bayless,PG,26,77,1717,220,516,0.426,37,120,0.308,183,396,0.462,0.462,121,137,0.883,22,189,211,233,59,12,133,163,598,OOR
Aron Baynes,C,28,70,1122,185,327,0.566,1,4,0.25,184,323,0.57,0.567,90,104,0.865,109,209,318,35,16,22,65,162,461,OOR
Kent Bazemore,SG,25,75,1324,141,331,0.426,48,132,0.364,93,199,0.467,0.498,60,100,0.6,21,201,222,78,52,33,73,127,390,OOR
Bradley Beal,SG,21,63,2107,363,851,0.427,106,259,0.409,257,592,0.434,0.489,130,166,0.783,57,184,241,194,76,18,123,136,962,OOR
Michael Beasley,PF,26,24,505,92,212,0.434,8,34,0.235,84,178,0.472,0.453,20,26,0.769,12,77,89,32,15,13,37,66,212,OOR
Marco Belinelli,SG,28,62,1388,199,470,0.423,86,230,0.374,113,240,0.471,0.515,84,99,0.848,26,131,157,94,31,3,61,85,568,OOR
Jerrelle Benimon,PF,23,2,3,0,0,0.0,0,0,0.0,0,0,0.0,0.0,0,0,0.0,1,2,3,0,0,0,1,0,0,OOR
Anthony Bennett,PF,21,57,894,125,297,0.421,7,23,0.304,118,274,0.431,0.433,41,64,0.641,52,164,216,48,27,16,36,87,298,OOR
Patrick Beverley,PG,26,56,1727,204,532,0.383,115,323,0.356,89,209,0.426,0.492,45,60,0.75,67,170,237,192,59,23,83,182,568,OOR
Sim Bhullar,C,22,3,3,1,2,0.5,0,0,0.0,1,2,0.5,0.5,0,0,0.0,0,1,1,1,0,1,0,0,2,OOR
Bismack Biyombo,C,22,64,1243,101,186,0.543,0,0,0.0,101,186,0.543,0.543,102,175,0.583,159,248,407,16,18,99,52,140,304,OOR
Tarik Black,C,23,63,1196,157,273,0.575,0,1,0.0,157,272,0.577,0.575,65,118,0.551,142,226,368,42,19,24,48,158,379,OOR
DeJuan Blair,PF,25,29,180,26,57,0.456,0,0,0.0,26,57,0.456,0.456,4,6,0.667,16,40,56,3,7,1,13,41,56,OOR
Steve Blake,PG,34,81,1529,122,327,0.373,77,219,0.352,45,108,0.417,0.491,29,41,0.707,16,121,137,288,41,5,104,118,350,OOR
Eric Bledsoe,PG,25,81,2800,468,1046,0.447,88,272,0.324,380,774,0.491,0.489,353,441,0.8,72,351,423,493,127,45,274,189,1377,OOR
Vander Blue,SG,22,2,74,9,30,0.3,2,10,0.2,7,20,0.35,0.333,2,5,0.4,2,7,9,8,3,0,6,4,22,OOR
Bojan Bogdanović,SF,25,78,1854,261,576,0.453,91,256,0.355,170,320,0.531,0.532,87,106,0.821,50,163,213,68,34,9,78,104,700,OOR
Andrew Bogut,C,30,67,1583,200,355,0.563,0,0,0.0,200,355,0.563,0.563,22,42,0.524,141,402,543,180,39,113,106,188,422,OOR
Matt Bonner,PF,34,72,935,94,230,0.409,46,126,0.365,48,104,0.462,0.509,30,37,0.811,29,86,115,47,10,12,11,65,264,OOR
Trevor Booker,PF,27,79,1564,226,464,0.487,29,84,0.345,197,380,0.518,0.518,86,148,0.581,139,258,397,83,43,41,88,144,567,OOR
Carlos Boozer,PF,33,71,1692,371,743,0.499,0,0,0.0,371,743,0.499,0.499,94,150,0.627,111,371,482,95,41,12,92,184,836,OOR
Chris Bosh,C,30,44,1556,343,745,0.46,63,168,0.375,280,577,0.485,0.503,179,232,0.772,46,264,310,95,41,25,95,69,928,OOR
Avery Bradley,SG,24,77,2428,434,1012,0.429,124,352,0.352,310,660,0.47,0.49,79,100,0.79,46,195,241,135,82,15,109,177,1071,OOR
Elton Brand,C,35,36,486,42,95,0.442,0,1,0.0,42,94,0.447,0.442,12,23,0.522,28,72,100,22,17,25,18,54,96,OOR
Corey Brewer,SF,28,80,2087,343,805,0.426,63,235,0.268,280,570,0.491,0.465,168,226,0.743,80,217,297,173,114,19,131,173,917,OOR
Aaron Brooks,PG,30,82,1885,344,817,0.421,121,313,0.387,223,504,0.442,0.495,145,174,0.833,32,134,166,261,54,15,157,189,954,OOR
Jabari Brown,SG,22,19,568,70,170,0.412,23,62,0.371,47,108,0.435,0.479,64,85,0.753,3,33,36,40,12,2,32,33,227,OOR
Lorenzo Brown,PG,24,29,549,52,122,0.426,6,28,0.214,46,94,0.489,0.451,12,19,0.632,14,56,70,90,28,6,30,49,122,OOR
Markel Brown,SG,23,47,781,76,210,0.362,17,64,0.266,59,146,0.404,0.402,47,57,0.825,16,91,107,39,31,12,27,57,216,OOR
Shannon Brown,SG,29,5,89,7,19,0.368,3,7,0.429,4,12,0.333,0.447,3,4,0.75,0,1,1,3,4,0,4,8,20,OOR
Kobe Bryant,SG,36,35,1207,266,713,0.373,54,184,0.293,212,529,0.401,0.411,196,241,0.813,26,173,199,197,47,7,128,65,782,OOR
Chase Budinger,SF,26,67,1286,169,390,0.433,52,143,0.364,117,247,0.474,0.5,67,81,0.827,33,165,198,64,44,10,49,72,457,OOR
Reggie Bullock,SF,23,36,338,24,70,0.343,15,46,0.326,9,24,0.375,0.45,6,9,0.667,1,49,50,8,10,4,8,19,69,OOR
Trey Burke,PG,22,76,2288,370,1005,0.368,124,390,0.318,246,615,0.4,0.43,109,145,0.752,31,173,204,328,65,15,124,119,973,OOR
Alec Burks,SG,23,27,899,121,300,0.403,26,68,0.382,95,232,0.409,0.447,106,129,0.822,19,95,114,82,17,5,52,64,374,OOR
Caron Butler,SF,34,78,1623,161,396,0.407,83,219,0.379,78,177,0.441,0.511,55,61,0.902,21,175,196,79,43,4,49,120,460,OOR
Jimmy Butler,SG,25,65,2513,421,912,0.462,73,193,0.378,348,719,0.484,0.502,386,463,0.834,114,265,379,212,114,36,93,108,1301,OOR
Rasual Butler,SF,35,75,1505,218,517,0.422,91,235,0.387,127,282,0.45,0.51,53,67,0.791,27,170,197,63,29,22,48,98,580,OOR
Dwight Buycks,PG,25,6,123,18,40,0.45,7,11,0.636,11,29,0.379,0.538,9,10,0.9,2,10,12,14,3,0,12,3,52,OOR
Will Bynum,SG,32,7,67,10,31,0.323,0,9,0.0,10,22,0.455,0.323,2,4,0.5,2,4,6,18,1,1,8,9,22,OOR
Bruno Caboclo,SF,19,8,23,4,12,0.333,2,3,0.667,2,9,0.222,0.417,0,0,0.0,1,1,2,0,0,1,4,3,10,OOR
Nick Calathes,SG,25,58,838,104,247,0.421,11,43,0.256,93,204,0.456,0.443,24,45,0.533,19,87,106,146,63,5,61,100,243,OOR
José Calderón,PG,33,42,1270,147,354,0.415,59,142,0.415,88,212,0.415,0.499,29,32,0.906,19,105,124,198,31,0,75,76,382,OOR
Kentavious Caldwell-Pope,SG,21,82,2587,390,972,0.401,153,444,0.345,237,528,0.449,0.48,110,158,0.696,46,209,255,109,93,18,94,161,1043,OOR
Isaiah Canaan,PG,23,47,938,146,378,0.386,91,246,0.37,55,132,0.417,0.507,49,60,0.817,18,69,87,98,29,3,62,83,432,OOR
Clint Capela,C,20,12,90,14,29,0.483,0,0,0.0,14,29,0.483,0.483,4,23,0.174,10,26,36,2,1,9,5,14,32,OOR
DeMarre Carroll,SF,28,70,2189,318,653,0.487,120,304,0.395,198,349,0.567,0.579,127,181,0.702,99,273,372,118,94,17,75,154,883,OOR
Vince Carter,SG,38,66,1091,135,406,0.333,69,232,0.297,66,174,0.379,0.417,45,57,0.789,27,106,133,79,43,14,43,102,384,OOR
Michael Carter-Williams,PG,23,66,2149,364,919,0.396,36,153,0.235,328,766,0.428,0.416,202,291,0.694,64,289,353,442,111,30,253,167,966,OOR
Omri Casspi,SF,26,67,1416,209,427,0.489,35,87,0.402,174,340,0.512,0.53,140,191,0.733,54,206,260,102,31,9,88,107,593,OOR
Mario Chalmers,PG,28,80,2368,267,663,0.403,73,248,0.294,194,415,0.467,0.458,206,266,0.774,24,182,206,307,122,10,173,251,813,OOR
Tyson Chandler,C,32,75,2286,293,440,0.666,0,0,0.0,293,440,0.666,0.666,185,257,0.72,294,570,864,84,42,91,105,169,771,OOR
Wilson Chandler,SF,27,78,2471,418,975,0.429,139,406,0.342,279,569,0.49,0.5,110,142,0.775,96,379,475,134,58,29,110,231,1085,OOR
Will Cherry,PG,23,8,69,5,19,0.263,2,9,0.222,3,10,0.3,0.316,3,6,0.5,1,4,5,8,6,1,4,10,15,OOR
Patrick Christopher,SG,26,4,29,3,12,0.25,0,4,0.0,3,8,0.375,0.25,0,0,0.0,2,4,6,0,1,0,1,6,6,OOR
Earl Clark,PF,27,10,93,11,30,0.367,4,14,0.286,7,16,0.438,0.433,1,4,0.25,1,22,23,3,3,4,6,12,27,OOR
Ian Clark,SG,23,30,192,19,55,0.345,10,30,0.333,9,25,0.36,0.436,9,9,1.0,4,12,16,12,9,3,9,20,57,OOR
Jordan Clarkson,PG,22,59,1476,267,596,0.448,38,121,0.314,229,475,0.482,0.48,131,158,0.829,56,135,191,206,51,12,96,109,703,OOR
Victor Claver,SF,26,10,76,9,20,0.45,6,11,0.545,3,9,0.333,0.6,0,0,0.0,3,17,20,1,1,1,4,12,24,OOR
Norris Cole,PG,26,75,1831,230,558,0.412,55,176,0.313,175,382,0.458,0.461,58,81,0.716,13,146,159,255,57,15,99,124,573,OOR
Darren Collison,PG,27,45,1565,260,550,0.473,60,161,0.373,200,389,0.514,0.527,145,184,0.788,19,124,143,252,67,14,112,95,725,OOR
Nick Collison,PF,34,66,1101,106,253,0.419,16,60,0.267,90,193,0.466,0.451,45,65,0.692,90,160,250,90,35,25,45,156,273,OOR
Mike Conley,PG,27,70,2225,393,882,0.446,107,277,0.386,286,605,0.473,0.506,214,249,0.859,29,180,209,375,89,14,156,139,1107,OOR
Jack Cooley,C,23,16,87,9,22,0.409,0,0,0.0,9,22,0.409,0.409,9,21,0.429,10,15,25,1,6,3,3,23,27,OOR
Chris Copeland,SF,30,50,828,112,310,0.361,52,167,0.311,60,143,0.42,0.445,33,45,0.733,23,88,111,51,11,11,59,78,309,OOR
Bryce Cotton,PG,22,15,159,29,69,0.42,7,20,0.35,22,49,0.449,0.471,15,18,0.833,3,15,18,15,4,0,12,6,80,OOR
DeMarcus Cousins,C,24,59,2013,498,1066,0.467,2,8,0.25,496,1058,0.469,0.468,423,541,0.782,185,562,747,210,90,103,254,241,1421,OOR
Robert Covington,SF,24,70,1956,299,756,0.396,167,446,0.374,132,310,0.426,0.506,178,217,0.82,65,251,316,105,97,31,128,189,943,OOR
Allen Crabbe,SG,22,51,683,63,153,0.412,30,85,0.353,33,68,0.485,0.51,12,16,0.75,7,66,73,39,19,15,15,74,168,OOR
Jamal Crawford,SG,34,64,1703,332,839,0.396,119,364,0.327,213,475,0.448,0.467,227,252,0.901,18,106,124,158,59,14,92,108,1010,OOR
Jae Crowder,SF,24,82,1647,229,545,0.42,61,208,0.293,168,337,0.499,0.476,109,141,0.773,72,221,293,94,72,25,49,137,628,OOR
Dante Cunningham,PF,27,66,1652,155,339,0.457,1,10,0.1,154,329,0.468,0.459,29,47,0.617,70,186,256,50,46,37,35,101,340,OOR
Jared Cunningham,SG,23,19,89,12,33,0.364,4,13,0.308,8,20,0.4,0.424,7,13,0.538,1,8,9,10,3,0,7,12,35,OOR
Seth Curry,PG,24,2,8,0,3,0.0,0,1,0.0,0,2,0.0,0.0,0,0,0.0,0,2,2,1,0,0,0,2,0,OOR
Stephen Curry,PG,26,80,2613,653,1341,0.487,286,646,0.443,367,695,0.528,0.594,308,337,0.914,56,285,341,619,163,16,249,158,1900,MVP
Samuel Dalembert,C,33,32,544,57,130,0.438,0,0,0.0,57,130,0.438,0.438,14,20,0.7,53,115,168,29,14,41,39,70,128,OOR
Troy Daniels,SG,23,47,397,61,165,0.37,43,118,0.364,18,47,0.383,0.5,11,13,0.846,8,25,33,22,6,1,20,40,176,OOR
Gigi Datome,SF,27,21,209,43,89,0.483,18,40,0.45,25,49,0.51,0.584,1,1,1.0,3,26,29,9,2,7,9,15,105,OOR
Brandon Davies,PF,23,27,423,55,137,0.401,8,34,0.235,47,103,0.456,0.431,24,37,0.649,38,45,83,30,18,7,29,59,142,OOR
Anthony Davis,PF,21,68,2455,642,1199,0.535,1,12,0.083,641,1187,0.54,0.536,371,461,0.805,173,523,696,149,100,200,95,141,1656,Candidate
Ed Davis,PF,25,79,1840,282,469,0.601,0,0,0.0,282,469,0.601,0.601,92,189,0.487,230,370,600,94,49,98,58,202,656,OOR
Glen Davis,PF,29,74,904,117,255,0.459,0,4,0.0,117,251,0.466,0.459,60,95,0.632,43,126,169,39,41,21,39,132,294,OOR
Andre Dawkins,SG,23,4,22,1,6,0.167,1,6,0.167,0,0,0.0,0.25,0,0,0.0,0,2,2,1,0,0,1,3,3,OOR
Austin Daye,SF,26,34,344,50,141,0.355,24,71,0.338,26,70,0.371,0.44,5,6,0.833,10,65,75,17,12,5,23,39,129,OOR
Dewayne Dedmon,C,25,59,845,91,162,0.562,0,1,0.0,91,161,0.565,0.562,34,64,0.531,118,177,295,9,16,50,51,141,216,OOR
Matthew Dellavedova,SG,24,67,1380,111,307,0.362,68,167,0.407,43,140,0.307,0.472,29,38,0.763,37,89,126,204,24,2,61,152,319,OOR
Luol Deng,SF,29,72,2421,369,787,0.469,78,220,0.355,291,567,0.513,0.518,191,251,0.761,103,273,376,139,65,22,108,109,1007,OOR
DeMar DeRozan,SG,25,60,2100,409,990,0.413,25,88,0.284,384,902,0.426,0.426,361,434,0.832,41,236,277,210,73,11,137,122,1204,OOR
Boris Diaw,PF,32,81,1984,291,632,0.46,54,169,0.32,237,463,0.512,0.503,72,93,0.774,78,270,348,233,36,23,126,148,708,OOR
Gorgui Dieng,C,25,73,2193,259,512,0.506,1,6,0.167,258,506,0.51,0.507,191,244,0.783,223,386,609,146,71,126,126,188,710,OOR
Spencer Dinwiddie,PG,21,34,455,51,169,0.302,12,65,0.185,39,104,0.375,0.337,31,34,0.912,4,44,48,104,19,6,33,53,145,OOR
Joey Dorsey,PF,31,69,854,80,145,0.552,0,1,0.0,80,144,0.556,0.552,24,83,0.289,103,176,279,25,40,25,41,157,184,OOR
Toney Douglas,SG,28,12,177,19,51,0.373,5,18,0.278,14,33,0.424,0.422,8,13,0.615,2,20,22,24,11,4,10,20,51,OOR
Chris Douglas-Roberts,SG,28,12,103,5,21,0.238,1,7,0.143,4,14,0.286,0.262,8,8,1.0,1,11,12,4,1,0,0,14,19,OOR
Goran Dragić,SG-PG,28,78,2640,502,1002,0.501,90,259,0.347,412,743,0.555,0.546,181,234,0.774,81,193,274,350,78,15,173,195,1275,OOR
Zoran Dragić,SG,25,16,75,11,30,0.367,3,14,0.214,8,16,0.5,0.417,3,5,0.6,5,3,8,5,2,0,5,6,28,OOR
Larry Drew II,PG,24,12,219,20,58,0.345,4,26,0.154,16,32,0.5,0.379,2,3,0.667,1,14,15,45,6,0,25,13,46,OOR
Andre Drummond,C,21,82,2502,494,961,0.514,0,2,0.0,494,959,0.515,0.514,142,365,0.389,437,667,1104,55,73,153,120,285,1130,OOR
Jared Dudley,SG,29,72,1717,198,423,0.468,74,192,0.385,124,231,0.537,0.556,48,67,0.716,45,175,220,130,72,11,62,113,518,OOR
Tim Duncan,C,38,77,2227,419,819,0.512,2,7,0.286,417,812,0.514,0.513,230,311,0.74,170,534,704,230,63,151,131,165,1070,OOR
Mike Dunleavy,SF,34,63,1838,209,481,0.435,107,263,0.407,102,218,0.468,0.546,70,87,0.805,28,220,248,114,39,21,60,123,595,OOR
Kevin Durant,SF,26,27,913,238,467,0.51,64,159,0.403,174,308,0.565,0.578,146,171,0.854,16,162,178,110,24,25,74,40,686,OOR
Cleanthony Early,SF,23,39,647,76,214,0.355,22,84,0.262,54,130,0.415,0.407,36,48,0.75,22,75,97,36,24,12,40,57,210,OOR
Wayne Ellington,SG,27,65,1675,254,617,0.412,90,243,0.37,164,374,0.439,0.485,52,64,0.813,31,179,210,105,33,2,50,77,650,OOR
Monta Ellis,SG,29,80,2699,602,1354,0.445,81,284,0.285,521,1070,0.487,0.475,228,303,0.752,34,156,190,329,148,25,198,197,1513,OOR
James Ennis,SF,24,62,1051,101,247,0.409,31,95,0.326,70,152,0.461,0.472,79,94,0.84,51,125,176,48,25,17,39,89,312,OOR
Tyler Ennis,PG,20,33,411,52,144,0.361,12,43,0.279,40,101,0.396,0.403,5,7,0.714,7,28,35,73,18,5,42,36,121,OOR
Jeremy Evans,SF,27,38,266,32,58,0.552,2,5,0.4,30,53,0.566,0.569,24,29,0.828,26,45,71,13,11,12,5,29,90,OOR
Reggie Evans,PF,34,47,764,58,137,0.423,0,2,0.0,58,135,0.43,0.423,60,97,0.619,97,202,299,32,22,5,45,91,176,OOR
Tyreke Evans,SG,25,79,2690,521,1165,0.447,69,227,0.304,452,938,0.482,0.477,202,291,0.694,82,334,416,521,100,37,246,198,1313,OOR
Dante Exum,PG,19,82,1817,145,416,0.349,83,264,0.314,62,152,0.408,0.448,20,32,0.625,27,104,131,198,41,14,118,147,393,OOR
Festus Ezeli,C,25,46,504,76,139,0.547,0,0,0.0,76,139,0.547,0.547,49,78,0.628,60,95,155,9,7,42,32,77,201,OOR
Kenneth Faried,PF,25,75,2086,373,736,0.507,1,8,0.125,372,728,0.511,0.507,199,288,0.691,242,426,668,89,62,57,118,211,946,OOR
Jordan Farmar,PG,28,36,529,61,158,0.386,35,97,0.361,26,61,0.426,0.497,10,11,0.909,8,34,42,67,20,5,32,52,167,OOR
Derrick Favors,PF,23,74,2280,482,918,0.525,1,6,0.167,481,912,0.527,0.526,222,332,0.669,196,411,607,112,60,123,121,210,1187,OOR
Raymond Felton,PG,30,29,281,43,106,0.406,10,34,0.294,33,72,0.458,0.453,12,15,0.8,2,24,26,41,11,4,18,17,108,OOR
Landry Fields,SF,26,26,216,20,41,0.488,1,2,0.5,19,39,0.487,0.5,5,6,0.833,10,16,26,15,11,0,8,9,46,OOR
Evan Fournier,SG,22,58,1661,253,575,0.44,85,225,0.378,168,350,0.48,0.514,107,147,0.728,28,125,153,120,40,2,82,116,698,OOR
Randy Foye,SG,31,50,1087,148,402,0.368,94,263,0.357,54,139,0.388,0.485,45,55,0.818,9,76,85,119,34,11,60,97,435,OOR
Jamaal Franklin,SG,23,3,13,1,2,0.5,1,2,0.5,0,0,0.0,0.75,0,0,0.0,1,1,2,3,0,1,3,4,3,OOR
Tim Frazier,PG,24,11,239,21,61,0.344,5,17,0.294,16,44,0.364,0.385,10,21,0.476,6,22,28,60,8,0,25,26,57,OOR
Jimmer Fredette,PG,25,50,509,63,166,0.38,9,48,0.188,54,118,0.458,0.407,43,45,0.956,8,32,40,58,15,2,33,43,178,OOR
Joel Freeland,C,27,48,617,74,151,0.49,0,0,0.0,74,151,0.49,0.49,21,25,0.84,62,129,191,16,9,23,23,93,169,OOR
Channing Frye,PF,31,75,1870,191,487,0.392,136,346,0.393,55,141,0.39,0.532,31,35,0.886,27,266,293,94,47,39,78,191,549,OOR
Danilo Gallinari,SF,26,59,1426,228,568,0.401,107,301,0.355,121,267,0.453,0.496,171,191,0.895,31,187,218,83,47,20,57,94,734,OOR
Langston Galloway,PG,23,45,1457,204,511,0.399,62,176,0.352,142,335,0.424,0.46,63,78,0.808,37,153,190,150,52,12,61,129,533,OOR
Francisco García,SF,33,14,200,17,63,0.27,10,45,0.222,7,18,0.389,0.349,1,4,0.25,3,14,17,15,9,5,10,20,45,OOR
Kevin Garnett,PF,38,47,952,143,306,0.467,1,7,0.143,142,299,0.475,0.469,36,45,0.8,48,263,311,77,46,17,46,109,323,OOR
Marc Gasol,C,30,81,2687,530,1072,0.494,3,17,0.176,527,1055,0.5,0.496,350,440,0.795,115,515,630,307,70,131,176,208,1413,OOR
Pau Gasol,PF,34,78,2681,570,1153,0.494,12,26,0.462,558,1127,0.495,0.5,294,366,0.803,220,699,919,210,25,147,158,147,1446,OOR
Rudy Gay,SF,28,68,2408,508,1116,0.455,79,220,0.359,429,896,0.479,0.491,337,393,0.858,98,301,399,250,71,41,183,157,1432,OOR
Alonzo Gee,SF,27,54,662,87,186,0.468,13,35,0.371,74,151,0.49,0.503,54,77,0.701,37,57,94,25,35,7,33,58,241,OOR
Paul George,SF,24,6,91,18,49,0.367,9,22,0.409,9,27,0.333,0.459,8,11,0.727,4,18,22,6,5,1,12,11,53,OOR
Taj Gibson,PF,29,62,1692,254,506,0.502,0,0,0.0,254,506,0.502,0.502,132,184,0.717,162,234,396,71,36,75,77,162,640,OOR
Manu Ginóbili,SG,37,70,1587,251,589,0.426,89,258,0.345,162,331,0.489,0.502,147,204,0.721,28,183,211,293,67,20,154,138,738,OOR
Rudy Gobert,C,22,82,2158,258,427,0.604,0,2,0.0,258,425,0.607,0.604,170,273,0.623,265,510,775,109,64,189,111,175,686,OOR
Drew Gooden,PF,33,51,864,110,276,0.399,23,59,0.39,87,217,0.401,0.44,34,44,0.773,72,151,223,49,21,9,28,91,277,OOR
Archie Goodwin,SG,20,41,535,79,201,0.393,12,41,0.293,67,160,0.419,0.423,61,83,0.735,27,47,74,44,18,9,48,55,231,OOR
Aaron Gordon,PF,19,47,797,93,208,0.447,13,48,0.271,80,160,0.5,0.478,44,61,0.721,46,123,169,33,21,22,38,83,243,OOR
Ben Gordon,SG,31,56,790,129,295,0.437,35,97,0.361,94,198,0.475,0.497,56,67,0.836,6,57,63,50,14,1,55,60,349,OOR
Drew Gordon,PF,24,9,71,8,19,0.421,0,3,0.0,8,16,0.5,0.421,1,2,0.5,7,11,18,2,1,0,8,7,17,OOR
Eric Gordon,SG,26,61,2018,285,694,0.411,141,315,0.448,144,379,0.38,0.512,107,133,0.805,28,131,159,229,50,14,122,145,818,OOR
Marcin Gortat,C,30,82,2453,439,775,0.566,0,3,0.0,439,772,0.569,0.566,123,175,0.703,180,537,717,97,49,110,100,191,1001,OOR
Danny Granger,SF,31,30,613,65,162,0.401,30,84,0.357,35,78,0.449,0.494,28,37,0.757,20,60,80,17,13,6,24,67,188,OOR
Jerami Grant,SF,20,65,1377,124,352,0.352,49,156,0.314,75,196,0.383,0.422,114,193,0.591,49,149,198,79,40,68,85,144,411,OOR
Danny Green,SG,27,81,2312,322,738,0.436,191,457,0.418,131,281,0.466,0.566,111,127,0.874,54,289,343,158,101,87,93,163,946,OOR
Draymond Green,PF,24,79,2490,339,765,0.443,111,329,0.337,228,436,0.523,0.516,132,200,0.66,114,533,647,291,123,99,133,253,921,OOR
Erick Green,PG,23,43,410,61,162,0.377,14,47,0.298,47,115,0.409,0.42,10,12,0.833,7,24,31,39,12,0,14,26,146,OOR
Gerald Green,SG,29,74,1446,324,778,0.416,137,387,0.354,187,391,0.478,0.504,99,120,0.825,33,153,186,91,42,12,104,145,884,OOR
JaMychal Green,PF,24,24,164,27,47,0.574,0,6,0.0,27,41,0.659,0.574,8,10,0.8,19,26,45,4,5,5,14,25,62,OOR
Jeff Green,SF,28,78,2454,416,967,0.43,97,292,0.332,319,675,0.473,0.48,239,287,0.833,64,264,328,134,53,34,108,147,1168,OOR
Willie Green,SG,33,52,951,118,306,0.386,42,121,0.347,76,185,0.411,0.454,28,34,0.824,14,65,79,68,26,5,48,81,306,OOR
Blake Griffin,PF,25,67,2356,574,1144,0.502,10,25,0.4,564,1119,0.504,0.506,311,427,0.728,126,382,508,354,63,35,152,196,1469,OOR
Jorge Gutiérrez,PG,26,20,175,22,41,0.537,0,3,0.0,22,38,0.579,0.537,9,13,0.692,5,20,25,22,6,0,12,25,53,OOR
P.J. Hairston,SG,22,45,687,87,269,0.323,49,163,0.301,38,106,0.358,0.414,31,36,0.861,22,70,92,21,21,13,22,61,254,OOR
Jordan Hamilton,SF,24,14,122,14,35,0.4,10,21,0.476,4,14,0.286,0.543,0,0,0.0,2,14,16,7,2,0,4,14,38,OOR
Justin Hamilton,C,24,41,712,85,178,0.478,10,31,0.323,75,147,0.51,0.506,39,47,0.83,57,77,134,36,27,30,26,70,219,OOR
Tyler Hansbrough,PF,29,74,1058,86,165,0.521,1,7,0.143,85,158,0.538,0.524,97,139,0.698,106,159,265,21,30,15,20,141,270,OOR
Tim Hardaway Jr.,SG,22,70,1681,279,717,0.389,121,354,0.342,158,363,0.435,0.474,125,156,0.801,12,144,156,127,20,14,82,119,804,OOR
James Harden,SG,25,81,2981,647,1470,0.44,208,555,0.375,439,915,0.48,0.511,715,824,0.868,75,384,459,565,154,60,321,208,2217,Candidate
Maurice Harkless,SF,21,45,674,63,158,0.399,10,56,0.179,53,102,0.52,0.43,22,41,0.537,38,68,106,25,32,9,27,66,158,OOR
Devin Harris,PG,31,76,1685,219,524,0.418,95,266,0.357,124,258,0.481,0.509,132,162,0.815,13,122,135,237,78,14,85,147,665,OOR
Gary Harris,SG,20,55,719,66,217,0.304,21,103,0.204,45,114,0.395,0.353,35,47,0.745,21,43,64,29,39,7,38,71,188,OOR
Joe Harris,SG,23,51,493,48,120,0.4,31,84,0.369,17,36,0.472,0.529,9,15,0.6,7,34,41,26,7,2,27,62,136,OOR
Tobias Harris,SF,22,68,2369,442,949,0.466,87,239,0.364,355,710,0.5,0.512,193,245,0.788,73,357,430,124,69,36,115,134,1164,OOR
Udonis Haslem,PF,34,62,995,107,239,0.448,2,10,0.2,105,229,0.459,0.452,45,64,0.703,71,187,258,46,21,13,41,113,261,OOR
Spencer Hawes,PF,26,73,1274,163,415,0.393,55,176,0.313,108,239,0.452,0.459,44,68,0.647,30,228,258,88,24,53,61,173,425,OOR
Chuck Hayes,C,31,29,255,22,46,0.478,0,0,0.0,22,46,0.478,0.478,6,11,0.545,18,33,51,20,10,4,8,37,50,OOR
Gordon Hayward,SF,24,76,2618,484,1087,0.445,120,330,0.364,364,757,0.481,0.5,375,462,0.812,54,319,373,313,108,30,206,131,1463,OOR
Brendan Haywood,C,35,22,119,14,30,0.467,0,0,0.0,14,30,0.467,0.467,7,13,0.538,6,23,29,2,2,10,10,17,35,OOR
Gerald Henderson,SG,27,80,2315,370,847,0.437,45,136,0.331,325,711,0.457,0.463,184,217,0.848,36,237,273,206,51,22,110,135,969,OOR
Xavier Henry,SF,23,9,86,3,13,0.231,0,0,0.0,3,13,0.231,0.231,14,24,0.583,2,2,4,3,3,0,3,6,20,OOR
John Henson,C,24,67,1228,196,346,0.566,0,0,0.0,196,346,0.566,0.566,78,137,0.569,124,188,312,59,28,135,87,152,470,OOR
Roy Hibbert,C,28,76,1926,317,710,0.446,0,2,0.0,317,708,0.448,0.446,168,204,0.824,156,384,540,84,18,125,107,216,802,OOR
J.J. Hickson,C,26,73,1411,218,459,0.475,0,2,0.0,218,457,0.477,0.475,116,201,0.577,150,302,452,57,36,35,96,136,552,OOR
Nenê,PF,32,67,1693,307,601,0.511,1,5,0.2,306,596,0.513,0.512,122,202,0.604,84,261,345,123,66,22,124,180,737,OOR
George Hill,PG,28,43,1267,255,535,0.477,69,193,0.358,186,342,0.544,0.541,113,143,0.79,25,154,179,220,44,14,69,111,692,OOR
Jordan Hill,C,27,70,1874,357,777,0.459,3,11,0.273,354,766,0.462,0.461,124,168,0.738,174,382,556,103,34,52,106,164,841,OOR
Solomon Hill,SF,23,82,2381,251,634,0.396,68,208,0.327,183,426,0.43,0.45,159,193,0.824,70,244,314,184,66,18,115,177,729,OOR
Kirk Hinrich,SG,34,66,1610,142,381,0.373,58,168,0.345,84,213,0.394,0.449,35,50,0.7,20,101,121,148,46,14,73,144,377,OOR
Jrue Holiday,PG,24,40,1303,238,534,0.446,51,135,0.378,187,399,0.469,0.493,65,76,0.855,32,103,135,274,63,23,91,110,592,OOR
Justin Holiday,SG,25,59,657,91,235,0.387,35,109,0.321,56,126,0.444,0.462,37,45,0.822,12,61,73,48,40,12,29,54,254,OOR
Ryan Hollins,C,30,46,441,53,82,0.646,0,0,0.0,53,82,0.646,0.646,31,54,0.574,36,67,103,14,6,19,25,65,137,OOR
Rodney Hood,SG,22,50,1064,155,374,0.414,62,170,0.365,93,204,0.456,0.497,61,80,0.763,9,108,117,83,30,12,45,119,433,OOR
Al Horford,C,28,76,2318,519,965,0.538,11,36,0.306,508,929,0.547,0.544,107,141,0.759,131,413,544,244,68,98,100,121,1156,OOR
Dwight Howard,C,29,41,1223,251,423,0.593,1,2,0.5,250,421,0.594,0.595,143,271,0.528,110,321,431,50,28,53,115,137,646,OOR
Lester Hudson,SG,30,5,56,6,14,0.429,3,6,0.5,3,8,0.375,0.536,3,4,0.75,1,7,8,5,6,1,3,4,18,OOR
Robbie Hummel,SF,25,45,742,79,172,0.459,16,51,0.314,63,121,0.521,0.506,24,29,0.828,31,103,134,27,16,9,18,86,198,OOR
Kris Humphries,PF,29,64,1345,211,446,0.473,0,7,0.0,211,439,0.481,0.473,87,117,0.744,118,298,416,57,34,25,46,130,509,OOR
Serge Ibaka,PF,25,64,2116,374,786,0.476,77,205,0.376,297,581,0.511,0.525,92,110,0.836,135,364,499,55,30,155,97,194,917,OOR
Andre Iguodala,SF,31,77,2069,231,496,0.466,74,212,0.349,157,284,0.553,0.54,68,114,0.596,44,213,257,228,89,25,88,100,604,OOR
Ersan İlyasova,PF,27,58,1319,263,557,0.472,74,190,0.389,189,367,0.515,0.539,69,107,0.645,80,197,277,56,36,19,45,149,669,OOR
Joe Ingles,SF,27,79,1673,147,354,0.415,72,202,0.356,75,152,0.493,0.517,30,40,0.75,22,153,175,182,72,10,98,124,396,OOR
Kyrie Irving,PG,22,75,2730,578,1235,0.468,157,378,0.415,421,857,0.491,0.532,315,365,0.863,55,182,237,389,114,20,186,146,1628,OOR
Jarrett Jack,PG,31,80,2241,359,817,0.439,39,146,0.267,320,671,0.477,0.463,200,227,0.881,19,226,245,373,75,13,191,143,957,OOR
Reggie Jackson,PG,24,77,2268,432,996,0.434,72,241,0.299,360,755,0.477,0.47,181,218,0.83,56,271,327,462,62,9,186,167,1117,OOR
Bernard James,C,29,16,158,12,27,0.444,0,0,0.0,12,27,0.444,0.444,20,23,0.87,18,21,39,4,2,15,6,17,44,OOR
LeBron James,SF,30,69,2493,624,1279,0.488,120,339,0.354,504,940,0.536,0.535,375,528,0.71,51,365,416,511,109,49,272,135,1743,Candidate
Al Jefferson,C,30,65,1992,486,1010,0.481,2,5,0.4,484,1005,0.482,0.482,108,165,0.655,99,449,548,113,47,84,68,139,1082,OOR
Cory Jefferson,PF,24,50,531,75,167,0.449,2,15,0.133,73,152,0.48,0.455,31,54,0.574,47,98,145,16,10,21,20,61,183,OOR
Richard Jefferson,SF,34,74,1244,144,324,0.444,66,155,0.426,78,169,0.462,0.546,78,114,0.684,25,158,183,61,32,11,52,115,432,OOR
John Jenkins,SG,23,24,297,49,99,0.495,21,52,0.404,28,47,0.596,0.601,16,19,0.842,2,37,39,13,10,0,8,15,135,OOR
Brandon Jennings,PG,25,41,1173,218,543,0.401,76,211,0.36,142,332,0.428,0.471,120,143,0.839,21,83,104,272,44,4,90,64,632,OOR
Jonas Jerebko,PF,27,75,1230,169,379,0.446,54,140,0.386,115,239,0.481,0.517,56,66,0.848,93,189,282,71,46,18,44,135,448,OOR
Grant Jerrett,PF,21,8,51,7,26,0.269,1,15,0.067,6,11,0.545,0.288,1,1,1.0,2,7,9,3,2,2,3,11,16,OOR
Amir Johnson,PF,27,75,1979,298,519,0.574,19,46,0.413,279,473,0.59,0.592,79,129,0.612,159,297,456,117,44,59,110,225,694,OOR
Chris Johnson,SF,24,29,526,62,154,0.403,28,95,0.295,34,59,0.576,0.494,14,16,0.875,8,47,55,15,26,7,15,44,166,OOR
James Johnson,PF,27,70,1370,238,404,0.589,11,51,0.216,227,353,0.643,0.603,67,102,0.657,61,196,257,95,54,70,79,155,554,OOR
Joe Johnson,SG,33,80,2791,446,1025,0.435,121,337,0.359,325,688,0.472,0.494,141,176,0.801,53,331,384,292,59,14,137,120,1154,OOR
Nick Johnson,SG,22,28,262,26,75,0.347,5,21,0.238,21,54,0.389,0.38,17,25,0.68,13,26,39,11,7,3,19,34,74,OOR
Tyler Johnson,SG,22,32,603,70,167,0.419,18,48,0.375,52,119,0.437,0.473,32,47,0.681,14,67,81,42,33,9,30,42,190,OOR
Wesley Johnson,SF,27,76,2245,286,691,0.414,91,259,0.351,195,432,0.451,0.48,90,112,0.804,67,252,319,124,59,45,87,162,753,OOR
Dahntay Jones,SF,34,33,123,6,21,0.286,0,4,0.0,6,17,0.353,0.286,9,11,0.818,1,10,11,2,3,0,1,23,21,OOR
James Jones,SF,34,57,669,74,201,0.368,63,175,0.36,11,26,0.423,0.525,39,46,0.848,9,53,62,24,13,8,13,67,250,OOR
Perry Jones,SF,23,43,631,73,184,0.397,14,60,0.233,59,124,0.476,0.435,24,37,0.649,6,70,76,18,17,8,24,50,184,OOR
Terrence Jones,PF,23,33,889,158,299,0.528,13,37,0.351,145,262,0.553,0.55,57,94,0.606,78,142,220,36,18,59,37,78,386,OOR
DeAndre Jordan,C,26,82,2820,379,534,0.71,1,4,0.25,378,530,0.713,0.711,187,471,0.397,397,829,1226,61,81,183,109,245,946,OOR
Jerome Jordan,C,28,44,383,50,94,0.532,0,0,0.0,50,94,0.532,0.532,38,44,0.864,52,53,105,13,8,15,22,58,138,OOR
Cory Joseph,PG,23,79,1444,207,411,0.504,16,44,0.364,191,367,0.52,0.523,105,143,0.734,44,148,192,188,46,17,67,105,535,OOR
Chris Kaman,C,32,74,1398,283,549,0.515,0,0,0.0,283,549,0.515,0.515,72,102,0.706,149,335,484,65,18,54,108,140,638,OOR
Enes Kanter,C,22,75,2135,482,928,0.519,16,45,0.356,466,883,0.528,0.528,183,234,0.782,277,394,671,55,36,29,145,189,1163,OOR
Sergey Karasev,SG,21,33,555,54,134,0.403,16,54,0.296,38,80,0.475,0.463,29,38,0.763,22,44,66,46,23,1,24,45,153,OOR
Ryan Kelly,PF,23,52,1233,104,309,0.337,45,134,0.336,59,175,0.337,0.409,79,95,0.832,13,133,146,92,30,24,37,118,332,OOR
Michael Kidd-Gilchrist,SF,21,55,1587,224,482,0.465,0,0,0.0,224,482,0.465,0.465,150,214,0.701,109,307,416,77,30,38,63,115,598,OOR
Sean Kilpatrick,SG,25,4,72,7,20,0.35,4,13,0.308,3,7,0.429,0.45,4,4,1.0,1,5,6,4,3,0,2,3,22,OOR
Andrei Kirilenko,SF,33,7,36,0,5,0.0,0,0,0.0,0,5,0.0,0.0,3,4,0.75,2,6,8,1,1,0,1,1,3,OOR
Alex Kirk,C,23,5,14,1,4,0.25,0,0,0.0,1,4,0.25,0.25,2,2,1.0,1,0,1,1,0,0,0,1,4,OOR
Brandon Knight,PG-SG,23,63,2035,375,888,0.422,125,321,0.389,250,567,0.441,0.493,195,223,0.874,28,216,244,330,90,10,189,114,1070,OOR
Kyle Korver,SG,33,75,2418,292,600,0.487,221,449,0.492,71,151,0.47,0.671,106,118,0.898,15,289,304,196,52,42,107,140,911,OOR
Kosta Koufos,C,25,81,1348,182,358,0.508,0,0,0.0,182,358,0.508,0.508,55,85,0.647,121,305,426,37,29,63,69,148,419,OOR
Ognjen Kuzmić,C,24,16,72,8,12,0.667,0,0,0.0,8,12,0.667,0.667,4,4,1.0,7,10,17,6,2,1,5,13,20,OOR
Jeremy Lamb,SG,22,47,633,104,250,0.416,38,111,0.342,66,139,0.475,0.492,49,55,0.891,8,99,107,44,21,6,27,52,295,OOR
Carl Landry,PF,31,70,1192,190,369,0.515,0,0,0.0,190,369,0.515,0.515,123,150,0.82,99,169,268,26,15,17,54,132,503,OOR
Shane Larkin,PG,22,76,1865,187,432,0.433,35,116,0.302,152,316,0.481,0.473,61,78,0.782,29,147,176,226,93,9,83,150,470,OOR
Joffrey Lauvergne,C,23,24,268,36,89,0.404,3,16,0.188,33,73,0.452,0.421,18,28,0.643,27,50,77,13,8,10,22,43,93,OOR
Zach LaVine,PG,19,77,1902,286,677,0.422,57,167,0.341,229,510,0.449,0.465,149,177,0.842,27,187,214,276,54,10,193,158,778,OOR
Ty Lawson,PG,27,75,2665,404,926,0.436,70,205,0.341,334,721,0.463,0.474,265,363,0.73,42,192,234,720,92,9,185,128,1143,OOR
Ricky Ledo,SG,22,17,244,32,96,0.333,10,27,0.37,22,69,0.319,0.385,16,22,0.727,16,20,36,19,6,1,26,21,90,OOR
Courtney Lee,SG,29,77,2354,288,643,0.448,90,224,0.402,198,419,0.473,0.518,111,129,0.86,21,157,178,151,75,12,78,129,777,OOR
David Lee,PF,31,49,904,160,313,0.511,0,2,0.0,160,311,0.514,0.511,68,104,0.654,81,176,257,85,31,26,49,83,388,OOR
Malcolm Lee,SG,24,1,2,0,1,0.0,0,0,0.0,0,1,0.0,0.0,0,0,0.0,0,0,0,0,0,0,0,0,0,OOR
Alex Len,C,21,69,1518,179,353,0.507,1,3,0.333,178,350,0.509,0.508,73,104,0.702,142,312,454,32,34,105,74,213,432,OOR
Kawhi Leonard,SF,23,64,2033,394,822,0.479,67,192,0.349,327,630,0.519,0.52,202,252,0.802,85,376,461,161,148,48,97,128,1057,OOR
Meyers Leonard,C,22,55,847,125,245,0.51,47,112,0.42,78,133,0.586,0.606,30,32,0.938,46,204,250,32,10,14,39,113,327,OOR
Jon Leuer,PF,25,63,824,121,273,0.443,7,29,0.241,114,244,0.467,0.456,37,59,0.627,50,157,207,46,17,9,35,86,286,OOR
Damian Lillard,PG,24,82,2925,590,1360,0.434,196,572,0.343,394,788,0.5,0.506,344,398,0.864,49,329,378,507,97,21,222,164,1720,OOR
Jeremy Lin,PG,26,74,1907,277,654,0.424,65,176,0.369,212,478,0.444,0.473,213,268,0.795,26,170,196,339,82,32,166,189,832,OOR
Shaun Livingston,PG,29,78,1468,198,396,0.5,0,2,0.0,198,394,0.503,0.5,65,91,0.714,43,140,183,259,49,20,102,110,461,OOR
Brook Lopez,C,26,72,2100,506,987,0.513,1,10,0.1,505,977,0.517,0.513,223,274,0.814,214,321,535,50,43,126,104,206,1236,OOR
Robin Lopez,C,26,59,1638,234,437,0.535,0,1,0.0,234,436,0.537,0.535,98,127,0.772,190,204,394,55,16,84,73,122,566,OOR
Kevin Love,PF,26,75,2532,413,952,0.434,144,392,0.367,269,560,0.48,0.509,258,321,0.804,142,589,731,168,51,39,122,140,1228,OOR
Kyle Lowry,PG,28,70,2414,430,1043,0.412,132,391,0.338,298,652,0.457,0.476,252,312,0.808,54,274,328,473,109,13,173,212,1244,OOR
Kalin Lucas,PG,25,1,6,0,1,0.0,0,0,0.0,0,1,0.0,0.0,0,0,0.0,0,0,0,0,1,0,0,1,0,OOR
John Lucas III,PG,32,21,272,42,104,0.404,9,29,0.31,33,75,0.44,0.447,5,5,1.0,4,12,16,60,8,0,16,18,98,OOR
Shelvin Mack,PG,24,55,833,117,292,0.401,40,127,0.315,77,165,0.467,0.469,25,31,0.806,8,71,79,155,30,2,49,32,299,OOR
Ian Mahinmi,C,28,61,1146,117,212,0.552,0,0,0.0,117,212,0.552,0.552,31,102,0.304,105,251,356,33,30,46,59,172,265,OOR
Devyn Marble,SG,22,16,208,14,44,0.318,4,22,0.182,10,22,0.455,0.364,5,16,0.313,5,26,31,17,9,2,9,14,37,OOR
Shawn Marion,SF,36,57,1101,119,267,0.446,12,46,0.261,107,221,0.484,0.468,26,34,0.765,64,138,202,51,27,27,33,58,276,OOR
Kendall Marshall,PG,23,28,417,46,101,0.455,18,46,0.391,28,55,0.509,0.545,8,9,0.889,2,26,28,86,21,0,35,26,118,OOR
Cartier Martin,SF,30,23,198,15,53,0.283,6,33,0.182,9,20,0.45,0.34,0,0,0.0,0,20,20,11,3,1,5,20,36,OOR
Kenyon Martin,PF,37,11,104,9,22,0.409,0,0,0.0,9,22,0.409,0.409,2,2,1.0,6,13,19,5,5,6,3,13,20,OOR
Kevin Martin,SG,31,39,1302,267,625,0.427,75,191,0.393,192,434,0.442,0.487,170,193,0.881,19,123,142,89,33,1,76,76,779,OOR
Wesley Matthews,SG,28,60,2024,337,752,0.448,173,445,0.389,164,307,0.534,0.563,109,145,0.752,38,184,222,139,77,10,81,132,956,OOR
Jason Maxiell,PF,31,61,878,81,192,0.422,0,0,0.0,81,192,0.422,0.422,41,71,0.577,86,117,203,19,18,44,29,96,203,OOR
O.J. Mayo,SG,27,71,1697,296,701,0.422,99,277,0.357,197,424,0.465,0.493,115,139,0.827,30,157,187,197,57,18,128,165,806,OOR
Luc Mbah a Moute,PF,28,67,1916,251,636,0.395,62,202,0.307,189,434,0.435,0.443,96,163,0.589,82,246,328,106,81,21,99,104,660,OOR
James Michael McAdoo,PF,22,15,137,24,44,0.545,0,0,0.0,24,44,0.545,0.545,14,25,0.56,15,22,37,2,5,9,6,21,62,OOR
Ray McCallum,PG,23,68,1436,206,470,0.438,34,111,0.306,172,359,0.479,0.474,57,84,0.679,52,128,180,188,45,11,85,92,503,OOR
CJ McCollum,SG,23,62,973,159,365,0.436,55,139,0.396,104,226,0.46,0.511,51,73,0.699,14,77,91,64,43,8,48,81,424,OOR
K.J. McDaniels,SG,21,62,1352,172,434,0.396,43,150,0.287,129,284,0.454,0.446,100,133,0.752,65,135,200,72,44,70,105,126,487,OOR
Doug McDermott,SF,23,36,321,43,107,0.402,13,41,0.317,30,66,0.455,0.463,10,15,0.667,6,37,43,6,4,1,17,29,109,OOR
Mitch McGary,PF,22,32,485,88,165,0.533,0,2,0.0,88,163,0.54,0.533,25,40,0.625,53,112,165,14,16,16,31,72,201,OOR
JaVale McGee,C,27,23,256,42,79,0.532,0,0,0.0,42,79,0.532,0.532,22,33,0.667,18,43,61,3,2,20,18,30,106,OOR
Ben McLemore,SG,21,82,2670,363,831,0.437,140,391,0.358,223,440,0.507,0.521,130,160,0.813,31,210,241,140,77,19,138,219,996,OOR
Jerel McNeal,PG,27,6,36,3,11,0.273,1,2,0.5,2,9,0.222,0.318,2,2,1.0,0,3,3,2,3,1,5,5,9,OOR
Josh McRoberts,PF,27,17,296,28,53,0.528,8,19,0.421,20,34,0.588,0.604,8,13,0.615,7,38,45,33,12,3,22,41,72,OOR
Jodie Meeks,SG,27,60,1462,222,534,0.416,74,212,0.349,148,322,0.46,0.485,145,160,0.906,12,92,104,79,59,6,57,76,663,OOR
Gal Mekel,PG,26,4,43,3,20,0.15,0,3,0.0,3,17,0.176,0.15,0,0,0.0,0,1,1,13,2,0,2,1,6,OOR
Khris Middleton,SF,23,79,2378,406,869,0.467,109,268,0.407,297,601,0.494,0.53,134,156,0.859,48,299,347,182,122,11,113,183,1055,OOR
C.J. Miles,SG,27,70,1841,329,827,0.398,154,446,0.345,175,381,0.459,0.491,130,161,0.807,18,196,214,75,60,26,73,132,942,OOR
Andre Miller,PG,38,81,1253,145,290,0.5,7,34,0.206,138,256,0.539,0.512,58,77,0.753,37,116,153,284,32,6,104,103,355,OOR
Darius Miller,SF,24,5,43,1,7,0.143,0,1,0.0,1,6,0.167,0.143,0,0,0.0,0,1,1,2,1,0,1,8,2,OOR
Mike Miller,SF,34,52,701,37,114,0.325,32,98,0.327,5,16,0.313,0.465,3,4,0.75,4,87,91,46,14,4,23,74,109,OOR
Quincy Miller,PF,22,10,119,9,38,0.237,3,18,0.167,6,20,0.3,0.276,8,11,0.727,4,16,20,8,7,5,5,9,29,OOR
Patty Mills,PG,26,51,801,128,336,0.381,62,182,0.341,66,154,0.429,0.473,33,40,0.825,21,54,75,87,28,2,35,58,351,OOR
Elijah Millsap,SG,27,47,924,81,238,0.34,28,90,0.311,53,148,0.358,0.399,58,86,0.674,28,122,150,58,56,16,67,124,248,OOR
Paul Millsap,PF,29,73,2390,443,930,0.476,77,216,0.356,366,714,0.513,0.518,255,337,0.757,139,431,570,223,130,69,166,201,1218,OOR
Nikola Mirotić,PF,23,82,1654,253,624,0.405,99,313,0.316,154,311,0.495,0.485,228,284,0.803,63,341,404,97,54,54,89,172,833,OOR
Nazr Mohammed,C,37,23,128,13,30,0.433,0,0,0.0,13,30,0.433,0.433,1,3,0.333,11,27,38,3,4,5,7,16,27,OOR
Greg Monroe,PF,24,69,2137,423,853,0.496,0,0,0.0,423,853,0.496,0.496,252,336,0.75,229,475,704,142,78,34,149,148,1098,OOR
E'Twaun Moore,SG,25,56,504,62,139,0.446,13,38,0.342,49,101,0.485,0.493,12,20,0.6,12,34,46,33,20,6,14,45,149,OOR
Eric Moreland,PF,23,3,2,1,1,1.0,0,0,0.0,1,1,1.0,1.0,0,0,0.0,0,1,1,0,0,0,0,1,2,OOR
Darius Morris,PG,24,38,299,36,106,0.34,7,33,0.212,29,73,0.397,0.373,4,9,0.444,7,20,27,48,9,0,21,20,83,OOR
Marcus Morris,PF,25,81,2045,331,763,0.434,112,313,0.358,219,450,0.487,0.507,71,113,0.628,73,312,385,133,63,16,73,188,845,OOR
Markieff Morris,PF,25,82,2581,512,1100,0.465,57,179,0.318,455,921,0.494,0.491,177,232,0.763,110,396,506,192,101,39,170,245,1258,OOR
Anthony Morrow,SG,29,74,1806,285,615,0.463,141,325,0.434,144,290,0.497,0.578,79,89,0.888,40,155,195,60,54,11,38,135,790,OOR
Donatas Motiejūnas,PF,24,71,2037,353,700,0.504,49,133,0.368,304,567,0.536,0.539,100,166,0.602,137,284,421,130,56,34,123,203,855,OOR
Timofey Mozgov,C,28,81,2045,314,566,0.555,2,6,0.333,312,560,0.557,0.557,155,216,0.718,203,388,591,55,33,97,116,227,785,OOR
Shabazz Muhammad,SG,22,38,866,194,397,0.489,20,51,0.392,174,346,0.503,0.514,104,145,0.717,63,91,154,44,18,7,35,49,512,OOR
Toure' Murry,SG-PG,25,5,18,2,5,0.4,0,0,0.0,2,5,0.4,0.4,2,2,1.0,1,0,1,1,1,0,4,2,6,OOR
Mike Muscala,PF,23,40,502,83,151,0.55,9,22,0.409,74,129,0.574,0.579,22,25,0.88,52,67,119,25,16,19,21,52,197,OOR
Shabazz Napier,PG,23,51,1012,87,228,0.382,43,118,0.364,44,110,0.4,0.476,44,56,0.786,17,96,113,130,40,4,81,76,261,OOR
Gary Neal,SG,30,54,1193,188,503,0.374,50,164,0.305,138,339,0.407,0.423,117,135,0.867,14,115,129,100,23,1,65,88,543,OOR
Jameer Nelson,PG,32,63,1407,205,504,0.407,89,258,0.345,116,246,0.472,0.495,24,36,0.667,33,113,146,253,47,6,109,136,523,OOR
Andrew Nicholson,PF,25,40,492,83,190,0.437,13,41,0.317,70,149,0.47,0.471,15,25,0.6,17,65,82,22,6,12,24,51,194,OOR
Joakim Noah,C,29,67,2049,190,427,0.445,0,2,0.0,190,425,0.447,0.445,105,174,0.603,219,427,646,312,48,74,123,203,485,OOR
Nerlens Noel,C,20,75,2311,302,653,0.462,0,0,0.0,302,653,0.462,0.462,140,230,0.609,185,426,611,128,133,142,146,208,744,OOR
Lucas Nogueira,C,22,6,23,2,8,0.25,0,0,0.0,2,8,0.25,0.25,2,4,0.5,2,9,11,1,2,0,2,6,6,OOR
Steve Novak,SF-PF,31,35,197,22,56,0.393,19,48,0.396,3,8,0.375,0.563,0,2,0.0,2,20,22,11,0,2,5,23,63,OOR
Dirk Nowitzki,PF,36,77,2282,487,1062,0.459,104,274,0.38,383,788,0.486,0.508,255,289,0.882,44,413,457,143,39,33,82,160,1333,OOR
Jusuf Nurkić,C,20,62,1103,171,383,0.446,0,2,0.0,171,381,0.449,0.446,84,132,0.636,125,257,382,50,52,68,86,207,426,OOR
Johnny O'Bryant,PF,21,34,368,44,120,0.367,0,0,0.0,44,120,0.367,0.367,12,27,0.444,26,38,64,17,5,4,25,44,100,OOR
Kyle O'Quinn,PF,24,51,824,119,242,0.492,12,43,0.279,107,199,0.538,0.517,44,57,0.772,46,153,199,59,31,39,55,110,294,OOR
Victor Oladipo,SG,22,72,2573,473,1086,0.436,84,248,0.339,389,838,0.464,0.474,262,320,0.819,51,251,302,295,120,19,204,187,1292,OOR
Kelly Olynyk,C,23,64,1423,251,528,0.475,61,175,0.349,190,353,0.538,0.533,93,136,0.684,92,211,303,109,64,39,98,213,656,OOR
Arinze Onuaku,C,27,6,68,12,14,0.857,0,0,0.0,12,14,0.857,0.857,3,8,0.375,7,14,21,4,1,3,2,6,27,OOR
Zaza Pachulia,C,30,73,1730,240,529,0.454,0,3,0.0,240,526,0.456,0.454,126,160,0.788,197,303,500,178,80,21,133,170,606,OOR
Kostas Papanikolaou,SF,24,43,795,69,197,0.35,31,106,0.292,38,91,0.418,0.429,13,18,0.722,39,79,118,85,29,13,55,71,182,OOR
Jannero Pargo,PG,35,9,73,15,35,0.429,9,22,0.409,6,13,0.462,0.557,2,2,1.0,0,3,3,8,0,0,3,8,41,OOR
Jabari Parker,PF,19,25,738,129,263,0.49,4,16,0.25,125,247,0.506,0.498,46,66,0.697,50,88,138,42,31,5,47,42,308,OOR
Tony Parker,PG,32,68,1953,404,832,0.486,38,89,0.427,366,743,0.493,0.508,130,166,0.783,15,114,129,335,44,2,146,108,976,OOR
Chandler Parsons,SF,26,66,2186,383,829,0.462,132,347,0.38,251,482,0.521,0.542,139,193,0.72,64,259,323,161,69,19,96,140,1037,OOR
Patrick Patterson,PF,25,81,2156,240,535,0.449,105,283,0.371,135,252,0.536,0.547,63,80,0.788,127,306,433,155,60,44,54,149,648,OOR
Chris Paul,PG,29,82,2857,568,1170,0.485,139,349,0.398,429,821,0.523,0.545,289,321,0.9,52,324,376,838,156,15,190,203,1564,OOR
Adreian Payne,PF,23,32,739,91,220,0.414,1,9,0.111,90,211,0.427,0.416,30,46,0.652,48,114,162,30,19,9,44,88,213,OOR
Elfrid Payton,PG,20,82,2489,301,708,0.425,11,42,0.262,290,666,0.435,0.433,118,214,0.551,107,242,349,533,142,20,203,193,731,OOR
Nikola Peković,C,29,31,815,139,328,0.424,0,0,0.0,139,328,0.424,0.424,108,129,0.837,89,145,234,27,19,12,42,59,386,OOR
Kendrick Perkins,C,30,68,1148,102,227,0.449,0,1,0.0,102,226,0.451,0.449,42,83,0.506,91,229,320,51,16,42,95,162,246,OOR
Paul Pierce,SF,37,73,1914,293,656,0.447,118,303,0.389,175,353,0.496,0.537,164,210,0.781,45,249,294,144,46,24,92,160,868,OOR
Mason Plumlee,C,24,82,1743,280,489,0.573,0,3,0.0,280,486,0.576,0.573,157,317,0.495,175,337,512,74,65,63,106,207,717,OOR
Miles Plumlee,C,26,73,1194,136,254,0.535,0,0,0.0,136,254,0.535,0.535,22,46,0.478,112,208,320,34,41,66,51,111,294,OOR
Quincy Pondexter,SF-SG,26,75,1793,188,447,0.421,91,244,0.373,97,203,0.478,0.522,71,96,0.74,53,142,195,94,19,24,51,150,538,OOR
Otto Porter,SF,21,74,1432,176,391,0.45,35,104,0.337,141,287,0.491,0.495,58,79,0.734,70,151,221,65,44,30,52,97,445,OOR
Dwight Powell,PF,23,29,236,31,67,0.463,3,11,0.273,28,56,0.5,0.485,25,33,0.758,18,32,50,9,9,6,11,40,90,OOR
Phil Pressey,PG,23,50,600,64,174,0.368,16,65,0.246,48,109,0.44,0.414,33,49,0.673,13,67,80,117,30,6,41,54,177,OOR
A.J. Price,PG,28,26,324,51,137,0.372,15,57,0.263,36,80,0.45,0.427,16,24,0.667,6,26,32,46,7,0,14,15,133,OOR
Ronnie Price,PG,31,43,982,77,223,0.345,31,109,0.284,46,114,0.404,0.415,36,45,0.8,19,50,69,165,67,4,52,118,221,OOR
Pablo Prigioni,PG,37,67,1197,91,228,0.399,57,166,0.343,34,62,0.548,0.524,35,41,0.854,30,89,119,171,79,1,62,88,274,OOR
Tayshaun Prince,SF,34,58,1397,177,402,0.44,31,67,0.463,146,335,0.436,0.479,49,65,0.754,52,158,210,93,29,16,35,55,434,OOR
Miroslav Raduljica,C,27,5,23,3,8,0.375,0,0,0.0,3,8,0.375,0.375,2,2,1.0,2,3,5,0,1,0,2,8,8,OOR
Julius Randle,PF,20,1,14,1,3,0.333,0,0,0.0,1,3,0.333,0.333,0,2,0.0,0,0,0,0,0,0,1,1,2,OOR
Shavlik Randolph,PF,31,21,126,9,35,0.257,0,5,0.0,9,30,0.3,0.257,6,12,0.5,16,22,38,4,5,3,3,16,24,OOR
Zach Randolph,PF,33,71,2304,454,932,0.487,7,20,0.35,447,912,0.49,0.491,228,298,0.765,225,522,747,153,69,14,156,175,1143,OOR
J.J. Redick,SG,30,78,2409,447,938,0.477,200,458,0.437,247,480,0.515,0.583,183,203,0.901,22,145,167,137,39,8,95,134,1277,OOR
Glen Rice Jr.,SG,24,5,43,3,15,0.2,1,7,0.143,2,8,0.25,0.233,4,6,0.667,2,2,4,2,0,0,2,11,11,OOR
Jason Richardson,SG,34,19,416,62,178,0.348,31,96,0.323,31,82,0.378,0.435,17,22,0.773,13,53,66,38,13,3,16,28,172,OOR
Luke Ridnour,PG,33,47,683,75,176,0.426,20,63,0.317,55,113,0.487,0.483,18,21,0.857,8,60,68,96,20,4,38,67,188,OOR
Austin Rivers,PG-SG,22,76,1563,203,496,0.409,39,131,0.298,164,365,0.449,0.449,85,126,0.675,27,125,152,155,48,14,65,146,530,OOR
Andre Roberson,SG,23,67,1286,92,201,0.458,21,85,0.247,71,116,0.612,0.51,23,48,0.479,60,195,255,70,53,29,46,141,228,OOR
Brian Roberts,PG,29,72,1330,176,452,0.389,62,193,0.321,114,259,0.44,0.458,66,74,0.892,13,96,109,162,33,6,57,75,480,OOR
Glenn Robinson III,SG-SF,21,35,261,26,67,0.388,5,19,0.263,21,48,0.438,0.425,16,24,0.667,15,24,39,11,6,1,11,15,73,OOR
Nate Robinson,PG,30,42,591,88,255,0.345,31,112,0.277,57,143,0.399,0.406,31,46,0.674,17,33,50,97,20,3,30,76,238,OOR
Thomas Robinson,PF,23,54,798,126,260,0.485,0,2,0.0,126,258,0.488,0.485,56,106,0.528,95,208,303,33,32,20,59,104,308,OOR
Rajon Rondo,PG,28,68,2018,275,645,0.426,27,86,0.314,248,559,0.444,0.447,31,78,0.397,73,300,373,538,91,7,210,153,608,OOR
Derrick Rose,PG,26,51,1530,338,835,0.405,76,271,0.28,262,564,0.465,0.45,152,187,0.813,35,126,161,251,36,16,161,63,904,OOR
Terrence Ross,SF,23,82,2092,309,753,0.41,145,390,0.372,164,363,0.452,0.507,44,56,0.786,32,194,226,86,53,25,69,136,807,OOR
Ricky Rubio,PG,24,22,692,78,219,0.356,13,51,0.255,65,168,0.387,0.386,57,71,0.803,19,106,125,193,38,1,64,59,226,OOR
Damjan Rudež,SF,28,68,1047,119,263,0.452,69,170,0.406,50,93,0.538,0.584,16,23,0.696,8,39,47,53,16,5,47,79,323,OOR
Brandon Rush,SG,29,33,271,11,54,0.204,3,27,0.111,8,27,0.296,0.231,5,11,0.455,4,37,41,12,5,12,11,27,30,OOR
Robert Sacre,C,25,67,1133,126,306,0.412,0,1,0.0,126,305,0.413,0.412,55,82,0.671,89,144,233,55,28,43,36,121,307,OOR
John Salmons,SF,35,21,270,16,48,0.333,8,26,0.308,8,22,0.364,0.417,2,4,0.5,4,17,21,13,9,4,5,25,42,OOR
JaKarr Sampson,SF,21,74,1131,146,346,0.422,31,127,0.244,115,219,0.525,0.467,63,94,0.67,35,128,163,77,38,26,76,135,386,OOR
Larry Sanders,C,26,27,586,86,172,0.5,0,0,0.0,86,172,0.5,0.5,24,48,0.5,67,99,166,23,26,39,28,104,196,OOR
Dennis Schröder,PG,21,77,1516,284,665,0.427,52,148,0.351,232,517,0.449,0.466,148,179,0.827,29,135,164,317,49,4,150,127,768,OOR
Luis Scola,PF,34,81,1659,300,642,0.467,5,20,0.25,295,622,0.474,0.471,158,226,0.699,138,388,526,105,47,18,94,192,763,OOR
Mike Scott,PF,26,68,1123,201,453,0.444,66,192,0.344,135,261,0.517,0.517,61,77,0.792,45,154,199,75,25,3,39,83,529,OOR
Thabo Sefolosha,SF,30,52,976,104,249,0.418,25,78,0.321,79,171,0.462,0.468,45,58,0.776,53,170,223,75,53,21,38,67,278,OOR
Kevin Séraphin,C,25,79,1235,231,450,0.513,0,2,0.0,231,448,0.516,0.513,58,82,0.707,87,201,288,59,10,59,98,197,520,OOR
Ramon Sessions,PG,28,64,1188,125,334,0.374,19,60,0.317,106,274,0.387,0.403,133,173,0.769,23,121,144,182,29,0,86,73,402,OOR
Iman Shumpert,SG,24,62,1545,193,471,0.41,67,196,0.342,126,275,0.458,0.481,43,64,0.672,55,169,224,135,81,16,91,138,496,OOR
Alexey Shved,SG,26,42,767,133,335,0.397,47,139,0.338,86,196,0.439,0.467,121,150,0.807,23,76,99,106,30,6,48,48,434,OOR
Henry Sims,C,24,73,1399,238,502,0.474,4,22,0.182,234,480,0.488,0.478,106,137,0.774,121,238,359,79,39,30,99,135,586,OOR
Kyle Singler,SF,26,80,1743,172,446,0.386,96,241,0.398,76,205,0.371,0.493,40,52,0.769,33,161,194,85,47,21,55,153,480,OOR
Donald Sloan,PG,27,53,1107,145,355,0.408,41,131,0.313,104,224,0.464,0.466,60,77,0.779,12,131,143,190,23,0,65,47,391,OOR
Marcus Smart,PG,20,67,1808,175,477,0.367,91,272,0.335,84,205,0.41,0.462,82,127,0.646,61,161,222,208,99,18,90,176,523,OOR
Greg Smith,PF,24,42,363,30,49,0.612,0,0,0.0,30,49,0.612,0.612,20,39,0.513,26,53,79,9,7,11,11,53,80,OOR
Ish Smith,PG,26,55,832,143,367,0.39,18,60,0.3,125,307,0.407,0.414,34,57,0.596,15,85,100,180,36,6,78,50,338,OOR
J.R. Smith,SG,29,70,2080,315,755,0.417,163,426,0.383,152,329,0.462,0.525,54,72,0.75,30,188,218,195,82,22,97,163,847,OOR
Jason Smith,C,28,82,1785,257,592,0.434,15,42,0.357,242,550,0.44,0.447,127,153,0.83,98,226,324,140,32,44,104,205,656,OOR
Josh Smith,PF,29,83,2300,414,987,0.419,72,228,0.316,342,759,0.451,0.456,127,255,0.498,152,378,530,277,87,116,206,228,1027,OOR
Russ Smith,PG,23,12,65,8,25,0.32,2,11,0.182,6,14,0.429,0.36,12,13,0.923,1,5,6,8,3,0,12,13,30,OOR
Tony Snell,SF,23,72,1412,159,371,0.429,73,197,0.371,86,174,0.494,0.527,44,55,0.8,31,145,176,62,32,11,48,86,435,OOR
Marreese Speights,C,27,76,1207,318,646,0.492,5,18,0.278,313,628,0.498,0.496,150,178,0.843,109,216,325,72,20,34,82,189,791,OOR
Tiago Splitter,C,30,52,1030,169,303,0.558,0,0,0.0,169,303,0.558,0.558,90,120,0.75,91,161,252,78,35,37,60,103,428,OOR
Nik Stauskas,SG,21,73,1127,108,296,0.365,48,149,0.322,60,147,0.408,0.446,55,64,0.859,11,77,88,67,20,17,40,92,319,OOR
Lance Stephenson,SG,24,61,1573,207,550,0.376,18,105,0.171,189,445,0.425,0.393,69,110,0.627,39,238,277,240,38,8,128,134,501,OOR
Greg Stiemsma,C,29,17,66,6,8,0.75,0,0,0.0,6,8,0.75,0.75,2,4,0.5,9,6,15,3,2,0,7,15,14,OOR
David Stockton,PG,23,3,33,2,6,0.333,1,2,0.5,1,4,0.25,0.417,3,6,0.5,0,2,2,9,2,0,4,1,8,OOR
Jarnell Stokes,PF,21,19,126,21,37,0.568,0,0,0.0,21,37,0.568,0.568,15,28,0.536,16,18,34,4,5,5,7,25,57,OOR
Amar'e Stoudemire,PF,32,59,1245,273,490,0.557,0,4,0.0,273,486,0.562,0.557,134,186,0.72,110,219,329,45,29,38,78,161,680,OOR
Rodney Stuckey,PG,28,71,1874,332,754,0.44,55,141,0.39,277,613,0.452,0.477,177,216,0.819,36,212,248,219,56,10,118,131,896,OOR
Jared Sullinger,PF,22,58,1566,311,708,0.439,52,184,0.283,259,524,0.494,0.476,96,129,0.744,147,294,441,134,44,42,78,153,770,OOR
Jeff Taylor,SF,25,29,430,45,114,0.395,11,36,0.306,34,78,0.436,0.443,26,41,0.634,14,39,53,22,12,1,19,36,127,OOR
Jeff Teague,PG,26,73,2228,408,887,0.46,71,207,0.343,337,680,0.496,0.5,275,319,0.862,30,154,184,513,125,31,205,139,1162,OOR
Mirza Teletović,PF,29,40,892,122,319,0.382,62,193,0.321,60,126,0.476,0.48,33,46,0.717,27,167,194,46,14,16,53,74,339,OOR
Sebastian Telfair,PG,29,16,327,46,125,0.368,18,60,0.3,28,65,0.431,0.44,24,34,0.706,2,28,30,45,10,0,18,29,134,OOR
Garrett Temple,SG,28,52,735,68,170,0.4,33,88,0.375,35,82,0.427,0.497,35,48,0.729,24,66,90,56,42,9,34,76,204,OOR
Jason Terry,SG,37,77,1641,188,446,0.422,126,323,0.39,62,123,0.504,0.563,39,48,0.813,15,106,121,147,66,19,74,116,541,OOR
Isaiah Thomas,PG,25,67,1726,335,797,0.42,129,346,0.373,206,451,0.457,0.501,302,348,0.868,33,120,153,284,57,5,143,150,1101,OOR
Lance Thomas,PF-SF,26,62,1490,182,442,0.412,7,22,0.318,175,420,0.417,0.42,72,99,0.727,65,130,195,69,37,8,74,101,443,OOR
Malcolm Thomas,PF,26,17,194,18,40,0.45,0,7,0.0,18,33,0.545,0.45,9,13,0.692,16,40,56,7,3,1,13,17,45,OOR
Tyrus Thomas,PF,28,2,7,1,1,1.0,0,0,0.0,1,1,1.0,1.0,2,2,1.0,0,0,0,1,0,0,0,0,4,OOR
Hollis Thompson,SG,23,71,1776,224,543,0.413,115,287,0.401,109,256,0.426,0.518,63,89,0.708,53,145,198,85,57,26,66,141,626,OOR
Jason Thompson,PF,28,81,1991,201,428,0.47,0,1,0.0,201,427,0.471,0.47,89,143,0.622,139,391,530,85,33,57,84,239,491,OOR
Klay Thompson,SG,24,77,2455,602,1299,0.463,239,545,0.439,363,754,0.481,0.555,225,256,0.879,27,220,247,222,87,60,149,122,1668,OOR
Tristan Thompson,PF,23,82,2194,267,488,0.547,0,0,0.0,267,488,0.547,0.547,159,248,0.641,274,383,657,39,34,61,83,189,693,OOR
Marcus Thornton,SG,27,48,721,140,345,0.406,54,143,0.378,86,202,0.426,0.484,46,56,0.821,23,63,86,36,27,7,27,38,380,OOR
Anthony Tolliver,PF,29,76,1432,161,393,0.41,106,290,0.366,55,103,0.534,0.545,54,69,0.783,51,185,236,59,24,16,51,137,482,OOR
P.J. Tucker,SF,29,78,2383,261,596,0.438,87,252,0.345,174,344,0.506,0.511,104,143,0.727,114,388,502,122,107,23,96,179,713,OOR
Ronny Turiaf,C,32,2,19,0,0,0.0,0,0,0.0,0,0,0.0,0.0,0,0,0.0,0,1,1,2,0,0,0,0,0,OOR
Hedo Türkoğlu,SF,35,62,705,83,188,0.441,60,139,0.432,23,49,0.469,0.601,6,11,0.545,5,94,99,37,19,7,29,66,232,OOR
Evan Turner,SG,26,82,2260,320,746,0.429,33,119,0.277,287,627,0.458,0.451,106,141,0.752,40,377,417,449,83,19,198,180,779,OOR
Ekpe Udoh,PF,27,33,128,11,24,0.458,0,0,0.0,11,24,0.458,0.458,7,9,0.778,7,19,26,8,8,7,7,20,29,OOR
Beno Udrih,PG,32,79,1494,246,505,0.487,26,97,0.268,220,408,0.539,0.513,87,102,0.853,20,123,143,220,46,8,89,88,605,OOR
Jonas Valančiūnas,C,22,80,2096,373,652,0.572,0,1,0.0,373,651,0.573,0.572,217,276,0.786,215,478,693,39,33,95,109,222,963,OOR
Anderson Varejão,C,32,26,636,111,200,0.555,0,2,0.0,111,198,0.561,0.555,33,45,0.733,57,113,170,35,19,16,35,58,255,OOR
Greivis Vásquez,PG,28,82,1991,296,725,0.408,133,351,0.379,163,374,0.436,0.5,50,66,0.758,22,194,216,302,46,10,119,177,775,OOR
Charlie Villanueva,PF,30,64,678,150,362,0.414,83,221,0.376,67,141,0.475,0.529,20,35,0.571,30,119,149,19,15,22,28,64,403,OOR
Noah Vonleh,PF,19,25,259,30,76,0.395,5,13,0.385,25,63,0.397,0.428,18,26,0.692,28,58,86,4,4,9,11,20,83,OOR
Nikola Vučević,C,24,74,2529,631,1206,0.523,2,6,0.333,629,1200,0.524,0.524,164,218,0.752,238,572,810,147,54,54,148,220,1428,OOR
Dwyane Wade,SG,33,62,1971,509,1084,0.47,29,102,0.284,480,982,0.489,0.483,284,370,0.768,58,161,219,299,73,21,209,105,1331,OOR
Dion Waiters,SG,23,80,2208,375,946,0.396,73,246,0.297,302,700,0.431,0.435,117,172,0.68,41,151,192,163,90,21,113,155,940,OOR
Henry Walker,SF,27,24,628,58,168,0.345,45,132,0.341,13,36,0.361,0.479,14,18,0.778,7,75,82,29,24,9,24,76,175,OOR
Kemba Walker,PG,24,62,2119,378,981,0.385,85,280,0.304,293,701,0.418,0.429,234,283,0.827,35,185,220,318,89,31,100,92,1075,OOR
John Wall,PG,24,79,2837,519,1166,0.445,65,217,0.3,454,949,0.478,0.473,284,362,0.785,36,330,366,792,138,45,304,180,1387,OOR
Gerald Wallace,SF,32,32,286,14,34,0.412,1,3,0.333,13,31,0.419,0.426,6,15,0.4,17,40,57,11,15,4,18,19,35,OOR
T.J. Warren,SF,21,40,614,113,214,0.528,5,21,0.238,108,193,0.56,0.54,14,19,0.737,41,44,85,25,18,9,27,51,245,OOR
C.J. Watson,PG,30,57,1422,181,417,0.434,70,175,0.4,111,242,0.459,0.518,138,167,0.826,18,145,163,208,57,9,100,107,570,OOR
David Wear,PF,24,2,7,0,2,0.0,0,1,0.0,0,1,0.0,0.0,0,0,0.0,2,0,2,1,0,0,0,1,0,OOR
Travis Wear,SF,24,51,672,84,209,0.402,11,30,0.367,73,179,0.408,0.428,20,26,0.769,31,75,106,40,15,11,35,55,199,OOR
Martell Webster,SF,28,32,352,24,91,0.264,10,43,0.233,14,48,0.292,0.319,48,64,0.75,10,36,46,17,7,1,22,24,106,OOR
David West,PF,34,66,1895,323,686,0.471,4,20,0.2,319,666,0.479,0.474,119,161,0.739,108,341,449,223,48,48,120,160,769,OOR
Russell Westbrook,PG,26,67,2302,627,1471,0.426,86,288,0.299,541,1183,0.457,0.455,546,654,0.835,124,364,488,574,140,14,293,184,1886,Candidate
Hassan Whiteside,C,25,48,1142,243,387,0.628,0,0,0.0,243,387,0.628,0.628,78,156,0.5,145,337,482,6,27,123,58,129,564,OOR
Shayne Whittington,PF,23,20,108,19,42,0.452,1,6,0.167,18,36,0.5,0.464,18,23,0.783,10,19,29,6,5,2,5,18,57,OOR
Andrew Wiggins,SF,19,82,2969,497,1137,0.437,39,126,0.31,458,1011,0.453,0.454,354,466,0.76,134,240,374,170,86,50,177,190,1387,OOR
C.J. Wilcox,SG,24,21,101,16,38,0.421,7,19,0.368,9,19,0.474,0.513,2,2,1.0,1,6,7,8,3,1,10,7,41,OOR
Deron Williams,PG,30,68,2114,298,771,0.387,87,237,0.367,211,534,0.395,0.443,201,241,0.834,29,208,237,448,64,17,154,157,884,OOR
Derrick Williams,PF,23,74,1462,217,485,0.447,49,156,0.314,168,329,0.511,0.498,134,196,0.684,41,161,202,50,34,4,56,67,617,OOR
Elliot Williams,SG,25,13,119,14,37,0.378,8,18,0.444,6,19,0.316,0.486,1,4,0.25,0,8,8,12,4,0,4,12,37,OOR
Lou Williams,SG,28,80,2016,375,928,0.404,152,447,0.34,223,481,0.464,0.486,340,395,0.861,24,127,151,164,88,10,101,103,1242,OOR
Marvin Williams,PF,28,78,2035,210,495,0.424,95,265,0.358,115,230,0.5,0.52,62,87,0.713,58,328,386,100,69,36,60,146,577,OOR
Mo Williams,PG,32,68,1980,341,860,0.397,119,348,0.342,222,512,0.434,0.466,163,187,0.872,22,152,174,424,46,14,172,162,964,OOR
Reggie Williams,SF,28,20,105,15,39,0.385,3,19,0.158,12,20,0.6,0.423,4,4,1.0,5,12,17,10,1,0,2,12,37,OOR
Shawne Williams,SF,28,63,1087,121,300,0.403,64,178,0.36,57,122,0.467,0.51,35,40,0.875,36,130,166,44,25,21,30,135,341,OOR
Jeff Withey,C,24,37,259,32,64,0.5,0,0,0.0,32,64,0.5,0.5,34,50,0.68,23,41,64,11,4,18,12,26,98,OOR
Nate Wolters,PG,23,21,247,20,57,0.351,0,7,0.0,20,50,0.4,0.351,2,6,0.333,8,26,34,21,8,2,13,18,42,OOR
Brandan Wright,PF,27,75,1449,233,363,0.642,0,3,0.0,233,360,0.647,0.642,78,112,0.696,128,193,321,41,50,94,34,102,544,OOR
Dorell Wright,SF,29,48,592,72,190,0.379,41,108,0.38,31,82,0.378,0.487,34,42,0.81,14,97,111,41,20,11,18,55,219,OOR
Tony Wroten,PG,21,30,895,175,434,0.403,37,142,0.261,138,292,0.473,0.446,120,180,0.667,22,64,86,157,48,8,113,72,507,OOR
James Young,SG,19,31,332,36,102,0.353,17,66,0.258,19,36,0.528,0.436,16,29,0.552,9,33,42,13,8,2,5,22,105,OOR
Nick Young,SG,29,42,1000,174,476,0.366,83,225,0.369,91,251,0.363,0.453,132,148,0.892,17,79,96,41,23,11,44,83,563,OOR
Thaddeus Young,PF,26,76,2434,451,968,0.466,38,115,0.33,413,853,0.484,0.486,131,200,0.655,127,284,411,173,124,25,117,171,1071,OOR
Cody Zeller,C,22,62,1487,172,373,0.461,1,1,1.0,171,372,0.46,0.462,127,164,0.774,97,265,362,100,34,49,62,156,472,OOR
Tyler Zeller,C,25,82,1731,340,619,0.549,0,0,0.0,340,619,0.549,0.549,153,186,0.823,146,319,465,113,18,52,76,205,833,OOR
