Player,Pos,Age,G,MP,FG,FGA,FG%,3P,3PA,3P%,2P,2PA,2P%,eFG%,FT,FTA,FT%,ORB,DRB,TRB,AST,STL,BLK,TOV,PF,PTS,Status,Season
Steven Adams,C,26,63,1680,283,478,0.592,1,3,0.333,282,475,0.594,0.593,117,201,0.582,207,376,583,146,51,67,94,122,684,OOR,2020
Bam Adebayo,PF,22,72,2417,440,790,0.557,2,14,0.143,438,776,0.564,0.558,264,382,0.691,176,559,735,368,82,93,204,182,1146,OOR,2020
LaMarcus Aldridge,C,34,53,1754,391,793,0.493,61,157,0.389,330,636,0.519,0.532,158,191,0.827,103,289,392,129,36,87,74,128,1001,OOR,2020
Kyle Alexander,C,23,2,13,1,2,0.5,0,0,0.0,1,2,0.5,0.5,0,0,0.0,2,1,3,0,0,0,1,1,2,OOR,2020
Nickeil Alexander-Walker,SG,21,47,591,98,266,0.368,46,133,0.346,52,133,0.391,0.455,25,37,0.676,9,75,84,89,17,8,54,57,267,OOR,2020
Grayson Allen,SG,24,38,718,117,251,0.466,57,141,0.404,60,110,0.545,0.58,39,45,0.867,8,77,85,52,10,2,33,53,330,OOR,2020
Jarrett Allen,C,21,70,1852,302,465,0.649,0,6,0.0,302,459,0.658,0.649,171,270,0.633,216,455,671,110,40,92,77,162,775,OOR,2020
Kadeem Allen,PG,27,10,117,19,44,0.432,5,16,0.313,14,28,0.5,0.489,7,11,0.636,2,7,9,21,5,2,8,7,50,OOR,2020
Al-Farouq Aminu,PF,29,18,380,25,86,0.291,9,36,0.25,16,50,0.32,0.343,19,29,0.655,24,63,87,21,18,8,17,27,78,OOR,2020
Justin Anderson,SG,26,10,107,10,38,0.263,6,29,0.207,4,9,0.444,0.342,2,4,0.5,1,20,21,8,0,6,4,13,28,OOR,2020
Kyle Anderson,SF,26,67,1330,157,331,0.474,24,85,0.282,133,246,0.541,0.511,52,78,0.667,58,227,285,162,54,37,66,111,390,OOR,2020
Ryan Anderson,C,31,2,14,2,7,0.286,1,5,0.2,1,2,0.5,0.357,0,0,0.0,0,7,7,2,1,0,1,1,5,OOR,2020
Giannis Antetokounmpo,PF,25,63,1917,685,1238,0.553,89,293,0.304,596,945,0.631,0.589,398,629,0.633,140,716,856,354,61,66,230,195,1857,MVP,2020
Kostas Antetokounmpo,PF,22,5,20,3,3,1.0,0,0,0.0,3,3,1.0,1.0,1,2,0.5,2,1,3,2,0,0,1,2,7,OOR,2020
Thanasis Antetokounmpo,SF,27,20,129,24,48,0.5,0,10,0.0,24,38,0.632,0.5,7,17,0.412,12,12,24,15,7,2,12,18,55,OOR,2020
Carmelo Anthony,PF,35,58,1902,336,782,0.43,87,226,0.385,249,556,0.448,0.485,136,161,0.845,71,297,368,85,49,27,100,171,895,OOR,2020
OG Anunoby,SF,22,69,2066,286,566,0.505,89,228,0.39,197,338,0.583,0.584,72,102,0.706,80,284,364,108,96,45,79,167,733,OOR,2020
Ryan Arcidiacono,PG,25,58,930,90,220,0.409,54,138,0.391,36,82,0.439,0.532,27,38,0.711,20,90,110,96,27,3,37,96,261,OOR,2020
Trevor Ariza,SF,34,53,1493,142,324,0.438,77,207,0.372,65,117,0.556,0.557,62,74,0.838,34,212,246,91,69,15,56,111,423,OOR,2020
D.J. Augustin,PG,32,57,1420,184,461,0.399,70,201,0.348,114,260,0.438,0.475,161,181,0.89,22,100,122,262,34,1,86,72,599,OOR,2020
Deandre Ayton,C,21,38,1236,310,568,0.546,3,13,0.231,307,555,0.553,0.548,67,89,0.753,147,289,436,72,26,58,80,117,690,OOR,2020
Dwayne Bacon,SG,24,39,687,85,244,0.348,19,67,0.284,66,177,0.373,0.387,35,53,0.66,15,85,100,52,23,2,37,52,224,OOR,2020
Marvin Bagley III,C,20,13,334,78,167,0.467,4,22,0.182,74,145,0.51,0.479,25,31,0.806,29,68,97,10,6,12,18,43,185,OOR,2020
Lonzo Ball,PG,22,63,2025,277,687,0.403,148,395,0.375,129,292,0.442,0.511,43,76,0.566,71,312,383,438,88,38,193,128,745,OOR,2020
Mo Bamba,C,21,62,878,132,286,0.462,37,107,0.346,95,179,0.531,0.526,31,46,0.674,100,202,302,42,23,86,42,116,332,OOR,2020
J.J. Barea,PG,35,29,450,85,207,0.411,32,85,0.376,53,122,0.434,0.488,20,22,0.909,10,43,53,112,5,2,38,27,222,OOR,2020
Harrison Barnes,PF,27,72,2482,365,793,0.46,102,268,0.381,263,525,0.501,0.525,214,267,0.801,77,278,355,159,43,12,88,93,1046,OOR,2020
RJ Barrett,SG,19,56,1704,292,727,0.402,63,197,0.32,229,530,0.432,0.445,156,254,0.614,50,229,279,143,55,17,124,122,803,OOR,2020
Will Barton,SF,29,58,1916,332,738,0.45,108,288,0.375,224,450,0.498,0.523,102,133,0.767,76,289,365,212,61,29,88,121,874,OOR,2020
Keita Bates-Diop,PF-SF,24,44,744,100,234,0.427,34,103,0.33,66,131,0.504,0.5,54,75,0.72,25,102,127,30,19,24,17,43,288,OOR,2020
Nicolas Batum,SF,31,22,505,28,81,0.346,14,49,0.286,14,32,0.438,0.432,9,10,0.9,25,75,100,66,17,8,22,41,79,OOR,2020
Aron Baynes,C,33,42,934,183,381,0.48,59,168,0.351,124,213,0.582,0.558,56,75,0.747,71,166,237,67,10,23,50,141,481,OOR,2020
Kent Bazemore,SF,30,68,1688,200,534,0.375,84,244,0.344,116,290,0.4,0.453,113,147,0.769,27,267,294,93,74,40,91,196,597,OOR,2020
Darius Bazley,PF,19,61,1130,125,317,0.394,49,141,0.348,76,176,0.432,0.472,43,62,0.694,30,216,246,41,23,41,45,55,342,OOR,2020
Bradley Beal,SG,26,57,2053,593,1303,0.455,170,481,0.353,423,822,0.515,0.52,385,457,0.842,52,190,242,347,71,23,194,126,1741,OOR,2020
Malik Beasley,SG,23,55,1209,227,534,0.425,107,276,0.388,120,258,0.465,0.525,54,66,0.818,18,130,148,75,40,8,57,77,615,OOR,2020
Marco Belinelli,SG,33,57,883,123,314,0.392,67,178,0.376,56,136,0.412,0.498,48,58,0.828,7,92,99,69,12,1,19,45,361,OOR,2020
Jordan Bell,C,25,29,256,35,67,0.522,4,12,0.333,31,55,0.564,0.552,19,31,0.613,30,51,81,16,3,10,21,19,93,OOR,2020
DeAndre' Bembry,SG,25,43,915,104,228,0.456,15,65,0.231,89,163,0.546,0.489,26,48,0.542,34,118,152,81,55,19,60,84,249,OOR,2020
Dragan Bender,PF-C,22,16,286,41,92,0.446,15,43,0.349,26,49,0.531,0.527,10,14,0.714,16,57,73,28,4,9,21,42,107,OOR,2020
Dāvis Bertāns,PF,27,54,1583,265,610,0.434,200,472,0.424,65,138,0.471,0.598,104,122,0.852,35,210,245,92,37,33,59,139,834,OOR,2020
Patrick Beverley,PG,31,51,1342,147,341,0.431,80,206,0.388,67,135,0.496,0.548,31,47,0.66,57,209,266,183,54,25,66,156,405,OOR,2020
Khem Birch,C,27,48,922,73,143,0.51,0,1,0.0,73,142,0.514,0.51,66,101,0.653,91,129,220,50,20,23,31,91,212,OOR,2020
Goga Bitadze,C,20,54,471,70,150,0.467,8,42,0.19,62,108,0.574,0.493,24,33,0.727,25,81,106,23,10,37,28,65,172,OOR,2020
Bismack Biyombo,C,27,53,1029,151,278,0.543,0,0,0.0,151,278,0.543,0.543,91,151,0.603,120,188,308,50,10,49,48,116,393,OOR,2020
Nemanja Bjelica,PF,31,72,2011,314,653,0.481,134,320,0.419,180,333,0.541,0.583,69,84,0.821,111,347,458,203,62,40,99,216,831,OOR,2020
Eric Bledsoe,PG,30,61,1646,334,703,0.475,74,215,0.344,260,488,0.533,0.528,169,214,0.79,43,239,282,328,57,26,148,128,911,OOR,2020
Bogdan Bogdanović,SG,27,61,1766,337,766,0.44,164,441,0.372,173,325,0.532,0.547,86,116,0.741,26,181,207,207,64,15,102,133,924,OOR,2020
Bojan Bogdanović,SF,30,63,2083,418,935,0.447,189,457,0.414,229,478,0.479,0.548,250,277,0.903,39,220,259,131,34,7,159,110,1275,OOR,2020
Bol Bol,PF,20,7,87,14,28,0.5,4,9,0.444,10,19,0.526,0.571,8,10,0.8,5,14,19,6,2,6,10,11,40,OOR,2020
Jonah Bolden,C,24,7,47,4,11,0.364,0,4,0.0,4,7,0.571,0.364,2,4,0.5,3,6,9,0,3,2,2,10,10,OOR,2020
Marques Bolden,C,21,1,3,0,0,0.0,0,0,0.0,0,0,0.0,0.0,0,0,0.0,0,2,2,0,1,0,0,1,0,OOR,2020
Jordan Bone,PG,22,10,53,5,20,0.25,2,10,0.2,3,10,0.3,0.3,0,0,0.0,0,4,4,8,1,0,2,6,12,OOR,2020
Isaac Bonga,SF,20,66,1250,118,234,0.504,25,71,0.352,93,163,0.571,0.558,69,85,0.812,71,151,222,76,45,22,58,156,330,OOR,2020
Devin Booker,SG,23,70,2512,627,1283,0.489,141,398,0.354,486,885,0.549,0.544,468,509,0.919,29,268,297,456,49,18,264,213,1863,OOR,2020
Chris Boucher,C,27,62,819,141,299,0.472,38,118,0.322,103,181,0.569,0.535,91,116,0.784,107,170,277,26,22,61,28,114,411,OOR,2020
Brian Bowen,SF,21,6,31,3,10,0.3,0,2,0.0,3,8,0.375,0.3,0,0,0.0,1,6,7,0,0,1,1,3,6,OOR,2020
Ky Bowman,PG,22,45,1015,134,321,0.417,33,107,0.308,101,214,0.472,0.469,34,41,0.829,24,97,121,131,44,10,70,102,335,OOR,2020
Avery Bradley,SG,29,49,1186,170,383,0.444,63,173,0.364,107,210,0.51,0.526,20,24,0.833,18,97,115,63,43,5,47,110,423,OOR,2020
Tony Bradley,C,22,58,663,126,189,0.667,3,3,1.0,123,186,0.661,0.675,30,46,0.652,111,156,267,23,14,33,30,115,285,OOR,2020
Jarrell Brantley,PF,23,9,96,10,28,0.357,3,13,0.231,7,15,0.467,0.411,1,2,0.5,2,18,20,11,3,5,7,7,24,OOR,2020
Ignas Brazdeikis,SF,21,9,53,6,22,0.273,1,9,0.111,5,13,0.385,0.295,4,5,0.8,2,3,5,4,0,1,2,3,17,OOR,2020
Corey Brewer,PF,33,5,33,2,4,0.5,0,1,0.0,2,3,0.667,0.5,1,3,0.333,2,6,8,2,4,0,2,7,5,OOR,2020
Mikal Bridges,SF,23,73,2042,247,484,0.51,70,194,0.361,177,290,0.61,0.583,103,122,0.844,66,226,292,129,102,46,73,163,667,OOR,2020
Miles Bridges,SF,21,65,1995,319,753,0.424,99,300,0.33,220,453,0.486,0.489,106,131,0.809,88,274,362,114,40,48,95,132,843,OOR,2020
Oshae Brissett,SF,21,19,135,13,36,0.361,3,15,0.2,10,21,0.476,0.403,8,10,0.8,9,17,26,7,4,1,7,18,37,OOR,2020
Ryan Broekhoff,SF,29,17,180,22,59,0.373,20,51,0.392,2,8,0.25,0.542,7,8,0.875,5,38,43,11,5,4,6,15,71,OOR,2020
Malcolm Brogdon,PG,27,54,1666,326,744,0.438,75,230,0.326,251,514,0.488,0.489,166,186,0.892,46,216,262,381,35,10,131,98,893,OOR,2020
Dillon Brooks,SG,24,73,2112,435,1068,0.407,147,411,0.358,288,657,0.438,0.476,164,203,0.808,68,175,243,150,63,27,124,278,1181,OOR,2020
Bruce Brown,PG,23,58,1634,198,447,0.443,33,96,0.344,165,351,0.47,0.48,88,119,0.739,61,213,274,230,63,29,100,162,517,OOR,2020
Charlie Brown,SG,22,10,40,6,19,0.316,3,9,0.333,3,10,0.3,0.395,5,5,1.0,2,2,4,2,2,2,3,3,20,OOR,2020
Jaylen Brown,SG,23,57,1934,427,887,0.481,129,338,0.382,298,549,0.543,0.554,176,243,0.724,62,302,364,118,65,20,125,167,1159,OOR,2020
Moses Brown,C,20,9,33,4,10,0.4,0,0,0.0,4,10,0.4,0.4,3,8,0.375,3,11,14,1,1,1,3,7,11,OOR,2020
Sterling Brown,SF,24,52,767,95,256,0.371,44,136,0.324,51,120,0.425,0.457,32,40,0.8,31,152,183,51,29,7,42,54,266,OOR,2020
Troy Brown Jr.,SF,20,69,1782,273,622,0.439,61,179,0.341,212,443,0.479,0.488,109,139,0.784,76,307,383,178,85,7,79,132,716,OOR,2020
Jalen Brunson,PG,23,57,1022,181,388,0.466,43,120,0.358,138,268,0.515,0.522,61,75,0.813,22,112,134,188,22,4,66,74,466,OOR,2020
Thomas Bryant,C,22,46,1147,243,418,0.581,37,91,0.407,206,327,0.63,0.626,86,116,0.741,98,233,331,83,25,49,53,103,609,OOR,2020
Reggie Bullock,SG,28,29,684,90,224,0.402,37,111,0.333,53,113,0.469,0.484,17,21,0.81,13,55,68,42,25,3,19,56,234,OOR,2020
Trey Burke,PG,27,33,520,94,209,0.45,32,75,0.427,62,134,0.463,0.526,23,29,0.793,16,34,50,83,16,2,21,33,243,OOR,2020
Alec Burks,SF-SG,28,66,1754,321,768,0.418,116,301,0.385,205,467,0.439,0.493,235,265,0.887,48,234,282,189,62,17,91,128,993,OOR,2020
Deonte Burton,SF,26,39,356,43,125,0.344,10,53,0.189,33,72,0.458,0.384,8,14,0.571,7,50,57,17,7,10,19,34,104,OOR,2020
Jimmy Butler,SF,30,58,1959,345,758,0.455,29,119,0.244,316,639,0.495,0.474,438,525,0.834,106,280,386,350,103,32,127,81,1157,OOR,2020
Bruno Caboclo,C,24,30,244,38,89,0.427,6,33,0.182,32,56,0.571,0.461,8,9,0.889,23,37,60,12,15,17,13,31,90,OOR,2020
Devontae Cacok,C,23,1,9,3,6,0.5,0,0,0.0,3,6,0.5,0.5,0,0,0.0,2,3,5,1,0,0,0,0,6,OOR,2020
Kentavious Caldwell-Pope,SG,26,69,1762,237,507,0.467,92,239,0.385,145,268,0.541,0.558,79,102,0.775,38,104,142,111,57,14,62,128,645,OOR,2020
Vlatko Čančar,PF,22,14,45,6,15,0.4,1,6,0.167,5,9,0.556,0.433,4,4,1.0,5,5,10,3,1,1,3,7,17,OOR,2020
Clint Capela,C,25,39,1279,244,388,0.629,0,0,0.0,244,388,0.629,0.629,55,104,0.529,168,369,537,48,33,72,63,102,543,OOR,2020
DeMarre Carroll,SF-C,33,24,290,25,66,0.379,8,33,0.242,17,33,0.515,0.439,29,42,0.69,12,43,55,25,8,5,17,32,87,OOR,2020
Jevon Carter,PG,24,58,945,101,243,0.416,62,146,0.425,39,97,0.402,0.543,23,27,0.852,30,88,118,84,47,17,32,86,287,OOR,2020
Vince Carter,PF,43,60,876,107,304,0.352,61,202,0.302,46,102,0.451,0.452,23,29,0.793,18,106,124,48,23,25,33,90,298,OOR,2020
Wendell Carter Jr.,C,20,43,1256,183,343,0.534,6,29,0.207,177,314,0.564,0.542,112,152,0.737,139,266,405,51,33,36,72,162,484,OOR,2020
Michael Carter-Williams,SG,28,45,833,111,260,0.427,22,75,0.293,89,185,0.481,0.469,79,95,0.832,46,101,147,109,49,22,52,87,323,OOR,2020
Alex Caruso,PG,25,64,1175,120,291,0.412,40,120,0.333,80,171,0.468,0.481,69,94,0.734,17,106,123,124,70,18,53,98,349,OOR,2020
Willie Cauley-Stein,C,26,54,1097,175,302,0.579,0,1,0.0,175,301,0.581,0.579,40,66,0.606,84,231,315,70,49,61,40,121,390,OOR,2020
Tyson Chandler,C,37,26,219,14,18,0.778,0,0,0.0,14,18,0.778,0.778,6,13,0.462,25,41,66,6,6,8,8,32,34,OOR,2020
Wilson Chandler,PF,32,35,734,74,183,0.404,37,121,0.306,37,62,0.597,0.505,20,23,0.87,11,134,145,39,16,12,34,79,205,OOR,2020
Joe Chealey,PG,24,4,33,0,7,0.0,0,4,0.0,0,3,0.0,0.0,2,2,1.0,0,0,0,1,4,0,2,2,2,OOR,2020
Zylan Cheatham,PF,24,4,51,6,9,0.667,0,1,0.0,6,8,0.75,0.667,0,0,0.0,3,6,9,3,1,1,4,10,12,OOR,2020
Chris Chiozza,PG,24,28,401,55,140,0.393,27,72,0.375,28,68,0.412,0.489,5,5,1.0,9,44,53,83,21,4,32,37,142,OOR,2020
Marquese Chriss,PF,22,59,1196,210,385,0.545,8,39,0.205,202,346,0.584,0.556,120,156,0.769,114,251,365,114,39,62,78,122,548,OOR,2020
Gary Clark,SF-PF,25,42,567,54,133,0.406,39,111,0.351,15,22,0.682,0.553,9,10,0.9,37,73,110,17,6,22,10,46,156,OOR,2020
Brandon Clarke,PF,23,58,1300,296,479,0.618,23,64,0.359,273,415,0.658,0.642,85,112,0.759,92,253,345,81,32,48,55,100,700,OOR,2020
Jordan Clarkson,SG,27,71,1705,394,867,0.454,152,413,0.368,242,454,0.533,0.542,138,165,0.836,50,137,187,136,46,16,97,108,1078,OOR,2020
Nicolas Claxton,C,20,15,187,27,48,0.563,1,7,0.143,26,41,0.634,0.573,11,21,0.524,19,25,44,16,1,8,9,14,66,OOR,2020
Chris Clemons,SG,22,33,291,57,142,0.401,37,107,0.346,20,35,0.571,0.532,10,11,0.909,4,26,30,27,9,6,19,26,161,OOR,2020
Antonius Cleveland,SG,25,11,46,4,14,0.286,0,3,0.0,4,11,0.364,0.286,3,5,0.6,2,5,7,1,1,3,2,8,11,OOR,2020
Amir Coffey,SG,22,18,159,23,54,0.426,6,19,0.316,17,35,0.486,0.481,6,11,0.545,4,12,16,14,5,2,8,20,58,OOR,2020
John Collins,PF,22,41,1363,353,605,0.583,59,147,0.401,294,458,0.642,0.632,120,150,0.8,116,300,416,60,31,66,75,138,885,OOR,2020
Zach Collins,PF,22,11,290,32,68,0.471,7,19,0.368,25,49,0.51,0.522,6,8,0.75,25,44,69,16,5,5,14,36,77,OOR,2020
Mike Conley,PG,32,47,1363,232,567,0.409,96,256,0.375,136,311,0.437,0.494,115,139,0.827,33,118,151,208,36,5,92,104,675,OOR,2020
Pat Connaughton,SG,27,67,1243,137,301,0.455,55,166,0.331,82,135,0.607,0.547,31,40,0.775,60,224,284,107,25,31,52,70,360,OOR,2020
Quinn Cook,PG,26,44,508,91,214,0.425,31,85,0.365,60,129,0.465,0.498,11,14,0.786,11,40,51,49,12,2,33,27,224,OOR,2020
Tyler Cook,PF-SF,22,13,54,8,12,0.667,0,0,0.0,8,12,0.667,0.667,7,8,0.875,6,8,14,1,3,0,3,5,23,OOR,2020
Robert Covington,PF-C,29,70,2137,305,723,0.422,161,480,0.335,144,243,0.593,0.533,99,124,0.798,63,400,463,88,115,93,103,220,870,OOR,2020
Allen Crabbe,SG-SF,27,37,653,63,177,0.356,36,119,0.303,27,58,0.466,0.458,10,14,0.714,11,66,77,33,15,4,17,47,172,OOR,2020
Torrey Craig,SF,29,58,1072,124,269,0.461,45,138,0.326,79,131,0.603,0.545,22,36,0.611,63,126,189,47,23,36,25,135,315,OOR,2020
Jamal Crawford,SG,39,1,6,2,4,0.5,1,2,0.5,1,2,0.5,0.625,0,0,0.0,0,0,0,3,0,0,0,1,5,OOR,2020
Jae Crowder,SF-PF,29,65,1875,226,563,0.401,135,394,0.343,91,169,0.538,0.521,97,125,0.776,52,332,384,161,72,24,69,143,684,OOR,2020
Jarrett Culver,SG,20,63,1506,230,569,0.404,66,221,0.299,164,348,0.471,0.462,54,117,0.462,70,142,212,110,57,38,81,125,580,OOR,2020
Seth Curry,SG,29,64,1576,284,574,0.495,145,321,0.452,139,253,0.549,0.621,80,97,0.825,27,118,145,124,38,9,62,113,793,OOR,2020
Stephen Curry,PG,31,5,139,33,82,0.402,12,49,0.245,21,33,0.636,0.476,26,26,1.0,4,22,26,33,5,2,16,11,104,OOR,2020
Troy Daniels,SG,28,47,532,72,186,0.387,46,132,0.348,26,54,0.481,0.511,10,16,0.625,12,40,52,17,11,3,12,37,200,OOR,2020
Anthony Davis,PF,26,62,2131,551,1096,0.503,72,218,0.33,479,878,0.546,0.536,444,525,0.846,142,435,577,200,91,143,154,156,1618,OOR,2020
Ed Davis,C,30,28,303,22,46,0.478,0,0,0.0,22,46,0.478,0.478,7,14,0.5,35,70,105,12,11,9,13,61,51,OOR,2020
Terence Davis,SG,22,72,1209,199,436,0.456,94,242,0.388,105,194,0.541,0.564,51,59,0.864,50,187,237,115,39,14,76,124,543,OOR,2020
Dewayne Dedmon,C,30,44,774,102,255,0.4,22,107,0.206,80,148,0.541,0.443,30,36,0.833,60,189,249,22,25,41,57,133,256,OOR,2020
Matthew Dellavedova,PG,29,57,821,62,175,0.354,21,91,0.231,41,84,0.488,0.414,32,37,0.865,18,57,75,180,20,2,59,78,177,OOR,2020
DeMar DeRozan,SF,30,68,2316,557,1049,0.531,9,35,0.257,548,1014,0.54,0.535,381,451,0.845,44,331,375,380,70,20,164,180,1504,OOR,2020
Cheick Diallo,C,23,47,479,92,142,0.648,1,3,0.333,91,139,0.655,0.651,34,39,0.872,30,101,131,22,11,12,32,55,219,OOR,2020
Hamidou Diallo,SF,21,46,896,132,296,0.446,16,57,0.281,116,239,0.485,0.473,38,63,0.603,44,123,167,36,37,9,51,101,318,OOR,2020
Gorgui Dieng,C,30,63,1096,166,364,0.456,54,152,0.355,112,212,0.528,0.53,78,101,0.772,91,263,354,73,51,59,60,124,464,OOR,2020
Spencer Dinwiddie,PG,26,64,1994,424,1021,0.415,123,400,0.308,301,621,0.485,0.476,347,446,0.778,32,189,221,432,40,21,174,180,1318,OOR,2020
Donte DiVincenzo,SG,23,66,1520,232,510,0.455,83,247,0.336,149,263,0.567,0.536,63,86,0.733,66,252,318,154,85,20,90,113,610,OOR,2020
Luka Dončić,PG,20,61,2047,581,1255,0.463,171,541,0.316,410,714,0.574,0.531,426,562,0.758,78,495,573,538,62,14,260,153,1759,Candidate,2020
Luguentz Dort,SF,20,36,820,86,218,0.394,30,101,0.297,56,117,0.479,0.463,42,53,0.792,24,57,81,27,31,4,22,97,244,OOR,2020
Damyean Dotson,SG,25,48,836,120,290,0.414,59,163,0.362,61,127,0.48,0.516,22,33,0.667,10,81,91,57,23,4,21,44,321,OOR,2020
Sekou Doumbouya,PF,19,38,754,92,236,0.39,28,98,0.286,64,138,0.464,0.449,31,46,0.674,20,98,118,19,20,8,35,80,243,OOR,2020
PJ Dozier,SG,23,29,412,65,157,0.414,17,49,0.347,48,108,0.444,0.468,21,29,0.724,10,45,55,63,14,6,27,45,168,OOR,2020
Goran Dragić,PG,33,59,1663,319,724,0.441,124,338,0.367,195,386,0.505,0.526,191,246,0.776,29,158,187,301,40,10,144,124,953,OOR,2020
Andre Drummond,C,26,57,1879,418,784,0.533,5,35,0.143,413,749,0.551,0.536,169,294,0.575,250,614,864,152,109,93,203,201,1010,OOR,2020
Jared Dudley,PF,34,45,364,24,60,0.4,18,42,0.429,6,18,0.333,0.55,2,2,1.0,6,46,52,28,15,3,8,41,68,OOR,2020
Kris Dunn,PG,25,51,1269,152,342,0.444,29,112,0.259,123,230,0.535,0.487,40,54,0.741,23,163,186,173,101,17,68,158,373,OOR,2020
Carsen Edwards,SG,21,37,351,42,128,0.328,24,76,0.316,18,52,0.346,0.422,13,19,0.684,6,41,47,24,12,4,15,34,121,OOR,2020
Henry Ellenson,C,23,5,15,1,7,0.143,0,4,0.0,1,3,0.333,0.143,0,0,0.0,2,4,6,1,0,0,0,1,2,OOR,2020
Wayne Ellington,SG,32,36,558,61,174,0.351,50,143,0.35,11,31,0.355,0.494,11,13,0.846,4,61,65,44,13,4,18,41,183,OOR,2020
Joel Embiid,C,25,51,1506,382,801,0.477,57,172,0.331,325,629,0.517,0.512,351,435,0.807,141,452,593,152,45,65,159,174,1172,OOR,2020
James Ennis,SF-SG,29,69,1265,160,359,0.446,55,169,0.325,105,190,0.553,0.522,79,98,0.806,71,174,245,63,35,22,58,137,454,OOR,2020
Drew Eubanks,C,22,22,272,43,67,0.642,1,1,1.0,42,66,0.636,0.649,20,26,0.769,28,57,85,15,5,17,21,37,107,OOR,2020
Jacob Evans,SG,22,29,418,45,134,0.336,13,39,0.333,32,95,0.337,0.384,25,29,0.862,9,32,41,31,11,12,25,41,128,OOR,2020
Dante Exum,SG,24,35,485,56,119,0.471,15,43,0.349,41,76,0.539,0.534,32,43,0.744,12,55,67,40,13,8,31,38,159,OOR,2020
Tacko Fall,C,24,7,33,11,14,0.786,0,0,0.0,11,14,0.786,0.786,1,3,0.333,1,14,15,1,1,4,3,7,23,OOR,2020
Derrick Favors,C,28,51,1243,209,339,0.617,1,7,0.143,208,332,0.627,0.618,40,71,0.563,163,338,501,81,30,46,55,107,459,OOR,2020
Cristiano Felício,C,27,22,386,34,54,0.63,0,2,0.0,34,52,0.654,0.63,18,23,0.783,55,47,102,16,10,2,18,34,86,OOR,2020
Terrance Ferguson,SF,21,56,1257,78,220,0.355,49,168,0.292,29,52,0.558,0.466,15,20,0.75,23,51,74,51,27,17,31,155,220,OOR,2020
Bruno Fernando,C,21,56,713,103,199,0.518,5,37,0.135,98,162,0.605,0.53,29,51,0.569,67,131,198,49,18,17,42,107,240,OOR,2020
Yogi Ferrell,PG,26,50,530,79,188,0.42,24,79,0.304,55,109,0.505,0.484,36,42,0.857,6,43,49,69,18,4,28,38,218,OOR,2020
Dorian Finney-Smith,PF,26,71,2120,243,522,0.466,114,303,0.376,129,219,0.589,0.575,78,108,0.722,145,260,405,114,45,39,69,178,678,OOR,2020
Bryn Forbes,SG,26,63,1579,242,581,0.417,148,381,0.388,94,200,0.47,0.544,75,90,0.833,12,114,126,108,33,0,57,113,707,OOR,2020
Evan Fournier,SF,27,66,2076,434,929,0.467,173,434,0.399,261,495,0.527,0.56,180,220,0.818,18,153,171,209,71,15,125,161,1221,OOR,2020
De'Aaron Fox,PG,22,51,1634,391,815,0.48,54,185,0.292,337,630,0.535,0.513,241,342,0.705,35,161,196,348,74,25,158,145,1077,OOR,2020
Melvin Frazier,SG,23,19,126,15,34,0.441,8,16,0.5,7,18,0.389,0.559,2,4,0.5,2,8,10,3,9,2,5,11,40,OOR,2020
Michael Frazier,SG,25,13,145,7,29,0.241,4,23,0.174,3,6,0.5,0.31,9,14,0.643,1,9,10,2,2,0,5,22,27,OOR,2020
Tim Frazier,PG,29,27,355,34,94,0.362,10,30,0.333,24,64,0.375,0.415,19,24,0.792,9,24,33,93,14,4,36,42,97,OOR,2020
Markelle Fultz,PG,21,72,1996,359,772,0.465,36,135,0.267,323,637,0.507,0.488,116,159,0.73,41,197,238,369,90,11,147,142,870,OOR,2020
Wenyen Gabriel,PF,22,30,235,21,48,0.438,6,20,0.3,15,28,0.536,0.5,15,22,0.682,21,31,52,8,11,7,16,39,63,OOR,2020
Daniel Gafford,C,21,43,609,94,134,0.701,0,0,0.0,94,134,0.701,0.701,32,60,0.533,52,54,106,21,13,56,29,98,220,OOR,2020
Danilo Gallinari,PF,31,62,1834,358,817,0.438,178,439,0.405,180,378,0.476,0.547,266,298,0.893,34,288,322,119,42,5,76,75,1160,OOR,2020
Langston Galloway,SG,28,66,1702,236,542,0.435,132,331,0.399,104,211,0.493,0.557,73,85,0.859,33,116,149,101,48,11,40,96,677,OOR,2020
Darius Garland,SG,20,59,1824,280,699,0.401,105,296,0.355,175,403,0.434,0.476,63,72,0.875,27,84,111,229,42,4,151,92,728,OOR,2020
Marc Gasol,C,35,44,1161,119,279,0.427,57,148,0.385,62,131,0.473,0.529,36,49,0.735,31,244,275,147,34,38,59,124,331,OOR,2020
Rudy Gay,PF,33,67,1461,266,596,0.446,74,220,0.336,192,376,0.511,0.508,120,136,0.882,61,301,362,114,35,33,88,103,726,OOR,2020
Paul George,SF,29,48,1419,343,782,0.439,157,381,0.412,186,401,0.464,0.539,190,217,0.876,24,248,272,185,68,20,125,113,1033,OOR,2020
Taj Gibson,C,34,62,1025,167,286,0.584,4,14,0.286,163,272,0.599,0.591,41,56,0.732,111,156,267,52,27,30,47,122,379,OOR,2020
Harry Giles,C,21,46,667,139,251,0.554,0,2,0.0,139,249,0.558,0.554,38,49,0.776,43,145,188,60,22,18,44,119,316,OOR,2020
Shai Gilgeous-Alexander,SG,21,70,2428,478,1015,0.471,87,251,0.347,391,764,0.512,0.514,288,357,0.807,47,365,412,232,79,47,134,117,1331,OOR,2020
Rudy Gobert,C,27,68,2333,386,557,0.693,0,0,0.0,386,557,0.693,0.693,254,403,0.63,230,686,916,101,51,135,130,215,1026,OOR,2020
Brandon Goodwin,PG,24,34,430,76,190,0.4,26,87,0.299,50,103,0.485,0.468,28,30,0.933,11,61,72,51,12,4,29,43,206,OOR,2020
Aaron Gordon,PF,24,62,2017,335,767,0.437,73,237,0.308,262,530,0.494,0.484,151,224,0.674,107,368,475,228,51,39,100,125,894,OOR,2020
Eric Gordon,SF,31,36,1016,171,463,0.369,96,303,0.317,75,160,0.469,0.473,82,107,0.766,9,62,71,54,23,13,43,70,520,OOR,2020
Devonte' Graham,PG,24,63,2211,368,963,0.382,218,585,0.373,150,378,0.397,0.495,191,233,0.82,42,170,212,471,62,15,181,115,1145,OOR,2020
Treveon Graham,SF,26,55,929,87,242,0.36,33,120,0.275,54,122,0.443,0.428,36,56,0.643,51,99,150,45,24,6,29,102,243,OOR,2020
Jerami Grant,PF,25,71,1892,303,634,0.478,98,252,0.389,205,382,0.537,0.555,147,196,0.75,58,190,248,88,50,57,63,154,851,OOR,2020
Jerian Grant,SG,27,6,80,10,27,0.37,2,8,0.25,8,19,0.421,0.407,5,7,0.714,2,4,6,9,1,1,3,11,27,OOR,2020
Josh Gray,PG,26,2,23,1,2,0.5,0,0,0.0,1,2,0.5,0.5,0,0,0.0,1,1,2,2,0,0,5,1,2,OOR,2020
Danny Green,SG,32,68,1687,197,474,0.416,120,327,0.367,77,147,0.524,0.542,33,48,0.688,51,174,225,91,85,32,63,136,547,OOR,2020
Draymond Green,PF,29,43,1222,123,316,0.389,36,129,0.279,87,187,0.465,0.446,63,83,0.759,23,243,266,266,59,33,98,110,345,OOR,2020
JaMychal Green,PF,29,63,1307,151,352,0.429,92,238,0.387,59,114,0.518,0.56,36,48,0.75,77,311,388,49,29,24,54,174,430,OOR,2020
Javonte Green,SG,26,48,468,63,126,0.5,9,33,0.273,54,93,0.581,0.536,28,42,0.667,24,69,93,26,24,8,23,43,163,OOR,2020
Jeff Green,PF-C,33,48,960,159,344,0.462,62,183,0.339,97,161,0.602,0.552,73,91,0.802,24,109,133,50,26,19,42,89,453,OOR,2020
Blake Griffin,PF,30,18,512,88,250,0.352,27,111,0.243,61,139,0.439,0.406,76,98,0.776,17,67,84,59,7,7,40,27,279,OOR,2020
Marko Guduric,SG,24,44,484,62,157,0.395,25,83,0.301,37,74,0.5,0.475,24,26,0.923,14,59,73,45,12,8,36,34,173,OOR,2020
Kyle Guy,SG,22,3,10,2,5,0.4,0,3,0.0,2,2,1.0,0.4,0,0,0.0,0,1,1,1,0,0,0,1,4,OOR,2020
Rui Hachimura,PF,21,48,1444,254,545,0.466,25,87,0.287,229,458,0.5,0.489,116,140,0.829,78,216,294,87,37,8,53,105,649,OOR,2020
Devon Hall,PG,24,11,81,6,30,0.2,4,17,0.235,2,13,0.154,0.267,4,8,0.5,2,5,7,13,4,1,5,6,20,OOR,2020
Donta Hall,C-PF,22,9,133,15,22,0.682,0,0,0.0,15,22,0.682,0.682,9,18,0.5,14,24,38,4,3,6,5,23,39,OOR,2020
Dusty Hannahs,SG,26,2,13,4,9,0.444,2,3,0.667,2,6,0.333,0.556,2,2,1.0,0,1,1,0,0,0,0,1,12,OOR,2020
Tim Hardaway Jr.,SG,27,71,2091,384,884,0.434,204,513,0.398,180,371,0.485,0.55,149,182,0.819,25,207,232,137,41,5,69,125,1121,OOR,2020
James Harden,SG,30,68,2483,672,1514,0.444,299,843,0.355,373,671,0.556,0.543,692,800,0.865,70,376,446,512,125,60,308,227,2335,Candidate,2020
Maurice Harkless,PF-SF,26,62,1427,142,283,0.502,34,98,0.347,108,185,0.584,0.562,39,66,0.591,55,185,240,68,58,33,53,148,357,OOR,2020
Jared Harper,PG,22,3,8,1,4,0.25,0,2,0.0,1,2,0.5,0.25,0,0,0.0,0,0,0,0,0,0,0,0,2,OOR,2020
Montrezl Harrell,C,26,63,1749,471,812,0.58,0,18,0.0,471,794,0.593,0.58,231,351,0.658,163,282,445,107,39,72,108,146,1173,OOR,2020
Gary Harris,SG,25,56,1780,218,519,0.42,70,210,0.333,148,309,0.479,0.487,75,92,0.815,26,137,163,118,76,14,60,116,581,OOR,2020
Joe Harris,SF,28,69,2123,381,784,0.486,172,406,0.424,209,378,0.553,0.596,64,89,0.719,64,234,298,144,41,17,104,159,998,OOR,2020
Tobias Harris,PF,27,72,2469,553,1173,0.471,131,357,0.367,422,816,0.517,0.527,174,216,0.806,69,426,495,227,53,40,104,165,1411,OOR,2020
Shaquille Harrison,SG,26,43,484,77,165,0.467,16,42,0.381,61,123,0.496,0.515,39,50,0.78,22,64,86,49,34,19,19,55,209,OOR,2020
Josh Hart,SF,24,65,1755,225,532,0.423,121,354,0.342,104,178,0.584,0.537,85,115,0.739,61,364,425,108,63,23,75,160,656,OOR,2020
Isaiah Hartenstein,C,21,23,266,44,67,0.657,0,5,0.0,44,62,0.71,0.657,19,28,0.679,29,61,90,18,9,12,16,41,107,OOR,2020
Udonis Haslem,C,39,4,44,4,11,0.364,1,3,0.333,3,8,0.375,0.409,3,4,0.75,1,15,16,1,0,0,1,6,12,OOR,2020
Jaxson Hayes,C,19,64,1080,174,259,0.672,1,4,0.25,173,255,0.678,0.674,123,190,0.647,97,162,259,56,26,55,53,161,472,OOR,2020
Gordon Hayward,SF,29,52,1740,350,700,0.5,85,222,0.383,265,478,0.554,0.561,124,145,0.855,55,293,348,212,38,22,96,96,909,OOR,2020
John Henson,C,29,40,600,95,171,0.556,8,36,0.222,87,135,0.644,0.579,23,46,0.5,46,116,162,54,24,42,36,78,221,OOR,2020
Dewan Hernandez,C,23,6,28,5,14,0.357,1,2,0.5,4,12,0.333,0.393,3,5,0.6,5,9,14,3,1,0,3,6,14,OOR,2020
Juan Hernangómez,PF,24,48,833,100,247,0.405,44,129,0.341,56,118,0.475,0.494,44,71,0.62,43,154,197,40,19,9,32,64,288,OOR,2020
Willy Hernangómez,C,25,31,375,74,139,0.532,5,22,0.227,69,117,0.59,0.55,37,59,0.627,43,91,134,29,10,7,30,32,190,OOR,2020
Tyler Herro,SG,20,55,1508,270,631,0.428,116,298,0.389,154,333,0.462,0.52,87,100,0.87,16,208,224,121,34,9,87,76,743,OOR,2020
Kevin Hervey,PF,23,10,52,7,27,0.259,3,20,0.15,4,7,0.571,0.315,0,0,0.0,1,11,12,5,1,1,0,4,17,OOR,2020
Mario Hezonja,PF,24,53,871,92,218,0.422,24,78,0.308,68,140,0.486,0.477,48,59,0.814,30,154,184,50,36,9,42,107,256,OOR,2020
Buddy Hield,SG,27,72,2216,498,1162,0.429,271,688,0.394,227,474,0.479,0.545,115,136,0.846,57,271,328,213,66,17,168,165,1382,OOR,2020
George Hill,PG,33,59,1271,194,376,0.516,81,176,0.46,113,200,0.565,0.624,85,101,0.842,50,127,177,180,47,5,57,84,554,OOR,2020
Solomon Hill,PF,28,59,1088,110,278,0.396,63,171,0.368,47,107,0.439,0.509,40,54,0.741,29,136,165,104,43,12,51,85,323,OOR,2020
Jaylen Hoard,PF,20,13,103,15,32,0.469,0,3,0.0,15,29,0.517,0.469,8,13,0.615,14,18,32,4,5,0,4,12,38,OOR,2020
Aaron Holiday,PG,23,66,1617,233,563,0.414,87,221,0.394,146,342,0.427,0.491,74,87,0.851,22,134,156,225,55,16,88,120,627,OOR,2020
Jrue Holiday,SG,29,61,2117,458,1006,0.455,122,346,0.353,336,660,0.509,0.516,129,182,0.709,77,216,293,408,99,48,184,145,1167,OOR,2020
Justin Holiday,SF,30,73,1826,208,486,0.428,134,331,0.405,74,155,0.477,0.566,53,67,0.791,32,206,238,93,87,46,44,137,603,OOR,2020
Rondae Hollis-Jefferson,PF,25,60,1122,155,329,0.471,3,23,0.13,152,306,0.497,0.476,105,143,0.734,110,173,283,106,46,23,59,115,418,OOR,2020
Richaun Holmes,C,26,44,1242,223,344,0.648,0,0,0.0,223,344,0.648,0.648,93,118,0.788,127,231,358,42,41,56,52,169,539,OOR,2020
Rodney Hood,SF,27,21,619,87,172,0.506,35,71,0.493,52,101,0.515,0.608,21,27,0.778,10,62,72,32,17,4,19,46,230,OOR,2020
Al Horford,C,33,67,2025,319,709,0.45,99,283,0.35,220,426,0.516,0.52,61,80,0.763,103,353,456,270,52,61,80,142,798,OOR,2020
Talen Horton-Tucker,SG,19,6,81,14,30,0.467,4,13,0.308,10,17,0.588,0.533,2,4,0.5,2,5,7,6,8,1,6,10,34,OOR,2020
Danuel House,SF,26,63,1913,230,539,0.427,129,355,0.363,101,184,0.549,0.546,73,90,0.811,57,210,267,85,67,34,54,132,662,OOR,2020
Dwight Howard,C,34,69,1306,202,277,0.729,3,5,0.6,199,272,0.732,0.735,110,214,0.514,172,335,507,45,31,79,84,222,517,OOR,2020
William Howard,PF,26,2,13,0,4,0.0,0,4,0.0,0,0,0.0,0.0,0,0,0.0,0,2,2,1,0,0,1,1,0,OOR,2020
Kevin Huerter,SG,21,56,1760,252,610,0.413,127,334,0.38,125,276,0.453,0.517,53,64,0.828,35,193,228,213,51,27,87,139,684,OOR,2020
De'Andre Hunter,SF,22,63,2018,280,683,0.41,108,304,0.355,172,379,0.454,0.489,110,144,0.764,44,242,286,112,44,18,103,182,778,OOR,2020
Chandler Hutchison,SF,23,28,527,80,175,0.457,12,38,0.316,68,137,0.496,0.491,46,78,0.59,18,90,108,26,27,7,27,47,218,OOR,2020
Serge Ibaka,C,30,55,1485,343,670,0.512,70,182,0.385,273,488,0.559,0.564,89,124,0.718,114,338,452,77,28,46,109,153,845,OOR,2020
Andre Iguodala,SF,36,21,418,38,88,0.432,14,47,0.298,24,41,0.585,0.511,6,15,0.4,17,61,78,51,14,21,26,35,96,OOR,2020
Ersan İlyasova,PF,32,63,986,146,313,0.466,50,137,0.365,96,176,0.545,0.546,72,87,0.828,62,240,302,49,24,17,34,95,414,OOR,2020
Joe Ingles,PF,32,72,2137,246,553,0.445,141,353,0.399,105,200,0.525,0.572,74,94,0.787,27,251,278,373,65,11,142,154,707,OOR,2020
Brandon Ingram,PF,22,62,2104,507,1096,0.463,150,384,0.391,357,712,0.501,0.531,313,368,0.851,51,329,380,259,61,38,189,179,1477,OOR,2020
Kyrie Irving,PG,27,20,658,199,416,0.478,56,142,0.394,143,274,0.522,0.546,94,102,0.922,22,81,103,128,27,10,52,53,548,OOR,2020
Jonathan Isaac,PF,22,34,980,156,332,0.47,32,94,0.34,124,238,0.521,0.518,60,77,0.779,58,173,231,48,53,78,49,83,404,OOR,2020
Wesley Iwundu,SF,25,52,953,97,233,0.416,28,82,0.341,69,151,0.457,0.476,78,97,0.804,24,107,131,60,25,13,26,80,300,OOR,2020
Frank Jackson,PG,21,59,797,134,331,0.405,47,144,0.326,87,187,0.465,0.476,56,75,0.747,22,61,83,61,17,4,49,77,371,OOR,2020
Jaren Jackson Jr.,C,20,57,1622,353,753,0.469,145,368,0.394,208,385,0.54,0.565,139,186,0.747,55,207,262,78,40,92,99,232,990,OOR,2020
Josh Jackson,SF,22,22,381,70,159,0.44,23,72,0.319,47,87,0.54,0.513,35,50,0.7,11,55,66,35,18,9,28,40,198,OOR,2020
Justin Jackson,PF,24,65,1045,135,341,0.396,48,163,0.294,87,178,0.489,0.466,42,50,0.84,27,127,154,52,15,10,14,69,360,OOR,2020
Reggie Jackson,SG-PG,29,31,743,134,326,0.411,57,145,0.393,77,181,0.425,0.498,45,54,0.833,17,75,92,126,13,5,51,59,370,OOR,2020
Justin James,SF,23,36,232,35,84,0.417,9,29,0.31,26,55,0.473,0.47,10,21,0.476,6,26,32,18,6,9,8,17,89,OOR,2020
LeBron James,PG,35,67,2316,643,1303,0.493,148,425,0.348,495,878,0.564,0.55,264,381,0.693,66,459,525,684,78,36,261,118,1698,Candidate,2020
Amile Jefferson,PF,26,18,74,5,14,0.357,0,0,0.0,5,14,0.357,0.357,5,14,0.357,10,13,23,4,1,3,3,7,15,OOR,2020
DaQuan Jeffries,SG,22,13,141,20,40,0.5,5,18,0.278,15,22,0.682,0.563,5,6,0.833,3,15,18,7,4,1,2,19,50,OOR,2020
Ty Jerome,SG,22,31,328,38,113,0.336,14,50,0.28,24,63,0.381,0.398,12,16,0.75,7,39,46,44,15,3,18,29,102,OOR,2020
Alize Johnson,PF,23,17,118,12,29,0.414,3,8,0.375,9,21,0.429,0.466,7,10,0.7,16,32,48,7,3,2,7,12,34,OOR,2020
B.J. Johnson,SF,24,10,83,9,32,0.281,3,9,0.333,6,23,0.261,0.328,9,10,0.9,3,12,15,3,3,0,6,3,30,OOR,2020
Cameron Johnson,PF,23,57,1255,176,405,0.435,106,272,0.39,70,133,0.526,0.565,46,57,0.807,49,138,187,69,36,20,32,88,504,OOR,2020
James Johnson,PF-C,32,32,619,103,215,0.479,33,91,0.363,70,124,0.565,0.556,31,48,0.646,25,93,118,74,25,32,48,80,270,OOR,2020
Keldon Johnson,SF,20,17,301,53,89,0.596,13,22,0.591,40,67,0.597,0.669,35,44,0.795,10,47,57,15,14,2,13,28,154,OOR,2020
Stanley Johnson,PF,23,25,150,22,59,0.373,7,24,0.292,15,35,0.429,0.432,9,16,0.563,7,30,37,20,6,4,15,16,60,OOR,2020
Tyler Johnson,PG-SG,27,39,709,97,250,0.388,38,119,0.319,59,131,0.45,0.464,42,50,0.84,18,58,76,74,16,9,29,58,274,OOR,2020
Nikola Jokić,C,24,73,2336,565,1071,0.528,80,255,0.314,485,816,0.594,0.565,246,301,0.817,166,545,711,512,85,44,226,222,1456,OOR,2020
Damian Jones,C,24,55,887,121,178,0.68,2,9,0.222,119,169,0.704,0.685,62,84,0.738,74,132,206,35,26,40,28,149,306,OOR,2020
Derrick Jones Jr.,SF,22,59,1375,184,349,0.527,37,132,0.28,147,217,0.677,0.58,95,123,0.772,66,167,233,62,58,38,30,130,500,OOR,2020
Tyus Jones,PG,23,65,1232,197,429,0.459,47,124,0.379,150,305,0.492,0.514,43,58,0.741,9,94,103,285,59,6,55,44,484,OOR,2020
DeAndre Jordan,C,31,56,1234,191,287,0.666,0,0,0.0,191,287,0.666,0.666,83,122,0.68,141,420,561,105,18,52,74,114,465,OOR,2020
Cory Joseph,PG,28,72,1759,171,412,0.415,56,159,0.352,115,253,0.455,0.483,60,70,0.857,44,144,188,251,53,21,80,133,458,OOR,2020
Mfiondu Kabengele,C,22,12,64,14,32,0.438,9,20,0.45,5,12,0.417,0.578,5,5,1.0,1,10,11,2,2,2,2,9,42,OOR,2020
Frank Kaminsky,C,26,39,777,138,307,0.45,41,124,0.331,97,183,0.53,0.516,61,90,0.678,35,141,176,75,14,10,37,75,378,OOR,2020
Enes Kanter,C,27,58,983,199,348,0.572,1,7,0.143,198,341,0.581,0.573,70,99,0.707,163,268,431,56,22,41,56,100,469,OOR,2020
Luke Kennard,SG,23,28,922,151,342,0.442,73,183,0.399,78,159,0.491,0.548,67,75,0.893,9,89,98,115,12,6,43,65,442,OOR,2020
Stanton Kidd,SG,27,4,15,0,3,0.0,0,1,0.0,0,2,0.0,0.0,0,0,0.0,0,3,3,1,0,0,2,3,0,OOR,2020
Michael Kidd-Gilchrist,PF,26,25,281,22,66,0.333,5,20,0.25,17,46,0.37,0.371,11,14,0.786,14,53,67,14,2,6,16,37,60,OOR,2020
Louis King,SF,20,10,62,8,21,0.381,4,11,0.364,4,10,0.4,0.476,0,3,0.0,1,9,10,5,2,0,2,10,20,OOR,2020
Maxi Kleber,PF,28,74,1890,237,514,0.461,119,319,0.373,118,195,0.605,0.577,79,93,0.849,112,276,388,88,25,83,58,176,672,OOR,2020
Brandon Knight,SG-PG,28,25,462,59,167,0.353,45,131,0.344,14,36,0.389,0.488,20,34,0.588,4,37,41,69,10,3,38,40,183,OOR,2020
Kevin Knox,SF,20,65,1166,144,401,0.359,65,199,0.327,79,202,0.391,0.44,66,101,0.653,28,156,184,61,23,28,45,106,419,OOR,2020
John Konchar,SG,23,19,181,24,37,0.649,5,10,0.5,19,27,0.704,0.716,1,2,0.5,18,29,47,22,7,3,7,7,54,OOR,2020
Furkan Korkmaz,SG,22,72,1559,242,563,0.43,143,356,0.402,99,207,0.478,0.557,77,102,0.755,18,150,168,79,41,16,59,98,704,OOR,2020
Luke Kornet,C,24,36,559,82,187,0.439,31,108,0.287,51,79,0.646,0.521,20,28,0.714,22,62,84,32,11,26,14,54,215,OOR,2020
Kyle Korver,SF,38,58,960,126,293,0.43,99,237,0.418,27,56,0.482,0.599,35,41,0.854,15,107,122,68,26,12,48,78,386,OOR,2020
Rodions Kurucs,PF,21,47,684,79,177,0.446,33,90,0.367,46,87,0.529,0.54,24,38,0.632,25,112,137,51,25,5,46,90,215,OOR,2020
Kyle Kuzma,PF,24,61,1526,291,668,0.436,86,272,0.316,205,396,0.518,0.5,114,155,0.735,52,221,273,80,28,26,91,126,782,OOR,2020
Skal Labissière,C,23,33,567,81,147,0.551,3,13,0.231,78,134,0.582,0.561,25,33,0.758,65,104,169,42,7,31,30,89,190,OOR,2020
Jeremy Lamb,SG,27,46,1291,216,479,0.451,53,158,0.335,163,321,0.508,0.506,92,110,0.836,24,176,200,96,55,22,50,104,577,OOR,2020
Romeo Langford,SG,20,32,370,28,80,0.35,5,27,0.185,23,53,0.434,0.381,18,25,0.72,15,26,41,13,8,8,11,33,79,OOR,2020
Zach LaVine,SG,24,60,2085,539,1199,0.45,184,484,0.38,355,715,0.497,0.526,268,334,0.802,41,248,289,254,88,28,206,131,1530,OOR,2020
Vic Law,PF,24,8,62,6,18,0.333,1,7,0.143,5,11,0.455,0.361,2,6,0.333,2,9,11,3,2,0,2,6,15,OOR,2020
Jake Layman,SF,25,23,505,81,179,0.453,24,72,0.333,57,107,0.533,0.52,24,32,0.75,17,40,57,15,17,10,24,47,210,OOR,2020
T.J. Leaf,PF,22,28,222,36,86,0.419,5,18,0.278,31,68,0.456,0.448,7,16,0.438,23,48,71,9,10,4,8,22,84,OOR,2020
Jalen Lecque,SG,19,5,32,4,10,0.4,0,4,0.0,4,6,0.667,0.4,2,2,1.0,0,2,2,2,0,0,2,3,10,OOR,2020
Courtney Lee,SG,34,24,345,40,82,0.488,21,47,0.447,19,35,0.543,0.616,6,7,0.857,7,25,32,12,18,6,11,33,107,OOR,2020
Damion Lee,SG,27,49,1423,213,511,0.417,85,239,0.356,128,272,0.471,0.5,110,126,0.873,32,207,239,133,50,6,67,116,621,OOR,2020
Alex Len,C,26,55,970,177,319,0.555,16,59,0.271,161,260,0.619,0.58,68,105,0.648,100,221,321,50,23,48,55,127,438,OOR,2020
Kawhi Leonard,SF,28,57,1848,532,1133,0.47,123,325,0.378,409,808,0.506,0.524,356,402,0.886,54,348,402,280,103,33,149,113,1543,Candidate,2020
Meyers Leonard,C,27,51,1034,119,234,0.509,53,128,0.414,66,106,0.623,0.622,18,28,0.643,30,230,260,55,14,15,39,107,309,OOR,2020
Caris LeVert,SG,25,45,1330,311,732,0.425,80,220,0.364,231,512,0.451,0.48,140,197,0.711,49,140,189,199,53,10,118,81,842,OOR,2020
Damian Lillard,PG,29,66,2474,624,1349,0.463,270,674,0.401,354,675,0.524,0.563,460,518,0.888,33,251,284,530,70,22,194,114,1978,OOR,2020
Nassir Little,PF,19,48,573,65,151,0.43,14,59,0.237,51,92,0.554,0.477,28,44,0.636,31,77,108,22,13,14,15,72,172,OOR,2020
Kevon Looney,C,23,20,262,29,79,0.367,1,14,0.071,28,65,0.431,0.373,9,12,0.75,28,38,66,20,12,6,12,34,68,OOR,2020
Brook Lopez,C,31,68,1817,292,671,0.435,102,325,0.314,190,346,0.549,0.511,127,152,0.836,58,254,312,99,46,163,70,163,813,OOR,2020
Robin Lopez,C,31,66,958,147,299,0.492,35,105,0.333,112,194,0.577,0.55,28,53,0.528,56,105,161,45,10,45,63,96,357,OOR,2020
Kevin Love,PF,31,56,1780,327,727,0.45,146,390,0.374,181,337,0.537,0.55,187,219,0.854,54,493,547,178,33,19,140,90,987,OOR,2020
Kyle Lowry,PG,33,58,2098,334,803,0.416,164,466,0.352,170,337,0.504,0.518,294,343,0.857,32,260,292,433,82,26,178,190,1126,OOR,2020
Timothé Luwawu-Cabarrot,SF,24,47,853,117,269,0.435,62,160,0.388,55,109,0.505,0.55,69,81,0.852,29,98,127,29,18,7,37,106,365,OOR,2020
Trey Lyles,PF,24,63,1271,153,343,0.446,65,168,0.387,88,175,0.503,0.541,33,45,0.733,71,290,361,69,28,28,39,98,404,OOR,2020
Daryl Macon,PG,24,4,14,1,3,0.333,1,2,0.5,0,1,0.0,0.5,0,0,0.0,0,0,0,1,0,0,2,1,3,OOR,2020
J.P. Macura,SG,24,1,1,0,0,0.0,0,0,0.0,0,0,0.0,0.0,0,0,0.0,0,0,0,0,0,0,0,0,0,OOR,2020
Josh Magette,PG,30,8,38,5,15,0.333,1,4,0.25,4,11,0.364,0.367,1,2,0.5,1,5,6,5,3,1,5,4,12,OOR,2020
Ian Mahinmi,C,33,38,808,104,210,0.495,5,26,0.192,99,184,0.538,0.507,70,113,0.619,78,140,218,49,31,44,45,114,283,OOR,2020
Thon Maker,C,22,60,776,93,193,0.482,22,64,0.344,71,129,0.55,0.539,73,110,0.664,54,113,167,43,25,39,45,102,281,OOR,2020
Terance Mann,SF,23,41,362,37,79,0.468,7,20,0.35,30,59,0.508,0.513,18,27,0.667,10,45,55,53,11,5,18,46,99,OOR,2020
Boban Marjanović,C,31,44,422,121,211,0.573,4,17,0.235,117,194,0.603,0.583,43,57,0.754,66,131,197,20,8,10,30,56,289,OOR,2020
Lauri Markkanen,PF,22,50,1492,251,591,0.425,109,317,0.344,142,274,0.518,0.517,126,153,0.824,60,253,313,74,42,23,81,96,737,OOR,2020
Caleb Martin,SF,24,18,317,37,84,0.44,20,37,0.541,17,47,0.362,0.56,17,21,0.81,10,28,38,23,12,7,15,32,111,OOR,2020
Cody Martin,SF,24,48,903,89,207,0.43,18,77,0.234,71,130,0.546,0.473,42,65,0.646,38,120,158,95,39,9,44,78,238,OOR,2020
Jeremiah Martin,PG,23,9,99,24,53,0.453,5,18,0.278,19,35,0.543,0.5,11,14,0.786,1,9,10,18,7,2,4,7,64,OOR,2020
Kelan Martin,SF,24,31,495,71,181,0.392,25,96,0.26,46,85,0.541,0.461,30,31,0.968,12,84,96,23,7,9,20,51,197,OOR,2020
Frank Mason III,PG,25,9,118,23,51,0.451,6,21,0.286,17,30,0.567,0.51,10,17,0.588,5,14,19,29,5,1,11,11,62,OOR,2020
Garrison Mathews,SG,23,18,227,24,56,0.429,19,46,0.413,5,10,0.5,0.598,31,34,0.912,6,18,24,10,8,1,8,32,98,OOR,2020
Wesley Matthews,SG,33,67,1635,167,422,0.396,108,297,0.364,59,125,0.472,0.524,52,68,0.765,22,144,166,92,38,9,43,103,494,OOR,2020
Luc Mbah a Moute,PF,33,3,25,2,5,0.4,0,2,0.0,2,3,0.667,0.4,1,2,0.5,1,1,2,0,2,0,1,0,5,OOR,2020
Patrick McCaw,SF,24,37,908,67,162,0.414,23,71,0.324,44,91,0.484,0.485,13,18,0.722,19,67,86,79,39,4,29,60,170,OOR,2020
CJ McCollum,SG,28,70,2556,611,1356,0.451,194,512,0.379,417,844,0.494,0.522,140,185,0.757,46,251,297,310,54,42,127,183,1556,OOR,2020
T.J. McConnell,PG,27,71,1326,212,411,0.516,5,17,0.294,207,394,0.525,0.522,35,42,0.833,38,151,189,355,56,11,100,73,464,OOR,2020
Jalen McDaniels,SF,22,16,293,33,70,0.471,9,24,0.375,24,46,0.522,0.536,14,17,0.824,15,50,65,13,8,3,11,36,89,OOR,2020
Doug McDermott,PF,28,69,1372,267,547,0.488,128,294,0.435,139,253,0.549,0.605,48,58,0.828,26,148,174,78,12,5,42,117,710,OOR,2020
JaVale McGee,C,32,68,1130,195,306,0.637,3,6,0.5,192,300,0.64,0.642,53,82,0.646,125,265,390,37,36,94,55,159,446,OOR,2020
Rodney McGruder,SG,28,56,871,72,181,0.398,24,89,0.27,48,92,0.522,0.464,19,34,0.559,29,122,151,36,26,8,24,74,187,OOR,2020
Alfonzo McKinnie,SF,27,40,593,73,171,0.427,14,65,0.215,59,106,0.557,0.468,22,31,0.71,37,76,113,14,23,8,26,72,182,OOR,2020
Jordan McLaughlin,PG,23,30,590,87,178,0.489,29,76,0.382,58,102,0.569,0.57,26,39,0.667,7,42,49,125,34,4,31,31,229,OOR,2020
Ben McLemore,SF,26,71,1619,242,545,0.444,181,452,0.4,61,93,0.656,0.61,50,67,0.746,21,136,157,58,45,16,50,155,715,OOR,2020
Jordan McRae,SG,28,37,784,149,366,0.407,45,126,0.357,104,240,0.433,0.469,83,109,0.761,18,106,124,93,21,16,43,73,426,OOR,2020
Nicolò Melli,C,29,60,1042,136,323,0.421,69,206,0.335,67,117,0.573,0.528,54,73,0.74,38,142,180,82,34,23,46,124,395,OOR,2020
De'Anthony Melton,PG,21,60,1167,161,401,0.401,40,140,0.286,121,261,0.464,0.451,93,121,0.769,43,177,220,175,77,20,84,109,455,OOR,2020
Chimezie Metu,C,22,18,105,24,42,0.571,0,2,0.0,24,40,0.6,0.571,10,13,0.769,12,21,33,10,3,6,10,7,58,OOR,2020
Khris Middleton,SF,28,62,1853,471,947,0.497,147,354,0.415,324,593,0.546,0.575,208,227,0.916,44,338,382,265,53,7,137,142,1297,OOR,2020
Eric Mika,C,25,1,19,2,3,0.667,0,0,0.0,2,3,0.667,0.667,2,2,1.0,2,5,7,0,0,0,0,5,6,OOR,2020
C.J. Miles,SF,32,10,161,19,59,0.322,11,35,0.314,8,24,0.333,0.415,15,20,0.75,4,8,12,12,10,4,4,14,64,OOR,2020
Malcolm Miller,SF,26,28,162,12,29,0.414,8,22,0.364,4,7,0.571,0.552,3,8,0.375,2,14,16,11,5,2,4,18,35,OOR,2020
Patty Mills,PG,31,66,1485,258,598,0.431,154,403,0.382,104,195,0.533,0.56,97,112,0.866,22,86,108,118,53,6,54,105,767,OOR,2020
Paul Millsap,PF,34,51,1240,211,438,0.482,54,124,0.435,157,314,0.5,0.543,115,141,0.816,98,195,293,83,44,30,70,150,591,OOR,2020
Shake Milton,SG,23,40,805,134,277,0.484,58,135,0.43,76,142,0.535,0.588,51,65,0.785,15,73,88,104,20,7,47,92,377,OOR,2020
Donovan Mitchell,SG,23,69,2364,602,1342,0.449,173,473,0.366,429,869,0.494,0.513,278,322,0.863,53,251,304,294,70,14,184,172,1655,OOR,2020
Naz Mitrou-Long,SG,26,5,47,6,17,0.353,2,12,0.167,4,5,0.8,0.412,0,0,0.0,0,7,7,8,1,1,3,2,14,OOR,2020
Adam Mokoka,SF,21,11,112,12,28,0.429,6,15,0.4,6,13,0.462,0.536,2,4,0.5,7,3,10,4,4,0,2,17,32,OOR,2020
Malik Monk,SG,21,55,1169,212,488,0.434,58,204,0.284,154,284,0.542,0.494,82,100,0.82,27,130,157,114,25,16,77,74,564,OOR,2020
Matt Mooney,SG,22,4,19,1,4,0.25,0,2,0.0,1,2,0.5,0.25,0,0,0.0,0,3,3,1,2,1,0,1,2,OOR,2020
E'Twaun Moore,SG,30,56,1020,186,437,0.426,63,167,0.377,123,270,0.456,0.498,31,45,0.689,31,100,131,78,32,11,40,80,466,OOR,2020
Ja Morant,PG,20,67,2074,447,937,0.477,60,179,0.335,387,758,0.511,0.509,239,308,0.776,51,208,259,488,58,18,220,110,1193,OOR,2020
Juwan Morgan,PF,22,21,134,15,26,0.577,3,8,0.375,12,18,0.667,0.635,3,4,0.75,10,19,29,6,1,2,6,19,36,OOR,2020
Marcus Morris,SF-PF,30,62,1936,355,810,0.438,142,348,0.408,213,462,0.461,0.526,181,220,0.823,59,252,311,86,47,30,97,180,1033,OOR,2020
Markieff Morris,PF,30,58,1187,203,458,0.443,88,228,0.386,115,230,0.5,0.539,66,85,0.776,40,178,218,77,31,17,76,133,560,OOR,2020
Monte Morris,PG,24,73,1636,260,566,0.459,65,172,0.378,195,394,0.495,0.517,75,89,0.843,24,113,137,255,55,17,53,73,660,OOR,2020
Johnathan Motley,PF,24,13,41,11,15,0.733,1,1,1.0,10,14,0.714,0.767,5,7,0.714,3,7,10,8,3,0,5,6,28,OOR,2020
Emmanuel Mudiay,PG,23,54,850,151,327,0.462,30,87,0.345,121,240,0.504,0.508,63,83,0.759,18,108,126,116,24,10,76,72,395,OOR,2020
Mychal Mulder,SF,25,7,204,26,67,0.388,16,52,0.308,10,15,0.667,0.507,9,12,0.75,3,20,23,8,2,1,5,20,77,OOR,2020
Dejounte Murray,PG,23,66,1687,294,637,0.462,41,111,0.369,253,526,0.481,0.494,91,114,0.798,69,314,383,271,111,17,125,143,720,OOR,2020
Jamal Murray,PG,22,59,1904,408,894,0.456,112,324,0.346,296,570,0.519,0.519,163,185,0.881,45,191,236,284,67,17,127,102,1091,OOR,2020
Džanan Musa,SF,20,40,487,64,172,0.372,19,78,0.244,45,94,0.479,0.427,45,60,0.75,21,65,86,43,15,1,36,30,192,OOR,2020
Mike Muscala,C,28,47,572,77,189,0.407,54,143,0.378,23,46,0.5,0.55,18,22,0.818,16,92,108,40,9,12,17,58,226,OOR,2020
Sviatoslav Mykhailiuk,SF,22,56,1265,166,405,0.41,115,285,0.404,51,120,0.425,0.552,57,70,0.814,17,87,104,106,41,4,61,87,504,OOR,2020
Abdel Nader,SF,26,55,867,123,263,0.468,48,128,0.375,75,135,0.556,0.559,51,66,0.773,14,86,100,38,23,20,43,78,345,OOR,2020
Larry Nance Jr.,PF,27,56,1472,229,431,0.531,56,159,0.352,173,272,0.636,0.596,50,74,0.676,106,303,409,123,56,22,60,91,564,OOR,2020
Shabazz Napier,PG,28,56,1344,188,456,0.412,76,240,0.317,112,216,0.519,0.496,126,153,0.824,26,132,158,262,69,11,128,101,578,OOR,2020
Raul Neto,PG,27,54,668,101,222,0.455,34,88,0.386,67,134,0.5,0.532,39,47,0.83,11,50,61,95,24,6,47,50,275,OOR,2020
Malik Newman,SG,22,1,4,0,2,0.0,0,1,0.0,0,1,0.0,0.0,2,2,1.0,0,0,0,0,0,0,1,0,2,OOR,2020
Georges Niang,PF,26,66,923,141,322,0.438,90,225,0.4,51,97,0.526,0.578,20,24,0.833,15,112,127,44,18,5,30,75,392,OOR,2020
Joakim Noah,C,34,5,50,4,8,0.5,0,0,0.0,4,8,0.5,0.5,6,8,0.75,5,11,16,7,1,1,6,9,14,OOR,2020
Nerlens Noel,C,25,61,1127,184,269,0.684,1,3,0.333,183,266,0.688,0.686,80,106,0.755,91,209,300,57,59,91,66,166,449,OOR,2020
Zach Norvell,SG,22,5,41,3,12,0.25,3,8,0.375,0,4,0.0,0.375,1,1,1.0,0,6,6,3,2,0,3,4,10,OOR,2020
Jaylen Nowell,SG,20,15,151,19,53,0.358,3,26,0.115,16,27,0.593,0.387,16,17,0.941,3,10,13,19,3,1,3,11,57,OOR,2020
Frank Ntilikina,PG,21,57,1187,131,333,0.393,44,137,0.321,87,196,0.444,0.459,51,59,0.864,23,98,121,172,54,16,71,142,357,OOR,2020
Kendrick Nunn,PG,24,67,1962,401,914,0.439,137,391,0.35,264,523,0.505,0.514,85,100,0.85,21,159,180,220,56,15,114,152,1024,OOR,2020
Jusuf Nurkić,C,25,8,253,54,109,0.495,2,10,0.2,52,99,0.525,0.505,31,35,0.886,23,59,82,32,11,16,19,39,141,OOR,2020
David Nwaba,SF,27,20,268,37,71,0.521,12,28,0.429,25,43,0.581,0.606,18,27,0.667,8,37,45,8,11,12,8,32,104,OOR,2020
Royce O'Neale,SF,26,71,2049,158,365,0.433,92,244,0.377,66,121,0.545,0.559,42,55,0.764,27,362,389,180,59,32,61,202,450,OOR,2020
Kyle O'Quinn,C,29,29,313,42,85,0.494,7,27,0.259,35,58,0.603,0.535,11,20,0.55,34,82,116,51,7,24,20,37,102,OOR,2020
Semi Ojeleye,PF,25,69,1011,80,196,0.408,48,127,0.378,32,69,0.464,0.531,28,32,0.875,26,119,145,37,21,5,19,80,236,OOR,2020
Jahlil Okafor,C,24,30,467,101,162,0.623,1,3,0.333,100,159,0.629,0.627,40,62,0.645,48,79,127,37,7,22,38,67,243,OOR,2020
Elie Okobo,PG,22,55,719,72,181,0.398,25,71,0.352,47,110,0.427,0.467,50,71,0.704,16,74,90,115,24,4,38,54,219,OOR,2020
Josh Okogie,SG,21,62,1547,170,398,0.427,41,154,0.266,129,244,0.529,0.479,152,191,0.796,87,181,268,99,68,26,87,139,533,OOR,2020
KZ Okpala,PF,20,5,26,3,5,0.6,0,1,0.0,3,4,0.75,0.6,1,2,0.5,1,4,5,1,2,1,1,2,7,OOR,2020
Victor Oladipo,SG,27,19,528,97,246,0.394,33,104,0.317,64,142,0.451,0.461,48,59,0.814,9,66,75,56,17,4,47,36,275,OOR,2020
Kelly Olynyk,C,28,67,1300,184,398,0.462,95,234,0.406,89,164,0.543,0.582,86,100,0.86,44,261,305,116,45,23,71,173,549,OOR,2020
Miye Oni,SF,22,10,109,12,32,0.375,7,19,0.368,5,13,0.385,0.484,4,5,0.8,5,12,17,4,4,2,4,9,35,OOR,2020
Cedi Osman,SF,24,65,1910,266,609,0.437,123,321,0.383,143,288,0.497,0.538,63,94,0.67,39,192,231,154,54,16,91,160,718,OOR,2020
Kelly Oubre Jr.,SF,24,56,1933,373,826,0.452,108,307,0.352,265,519,0.511,0.517,192,246,0.78,67,294,361,85,71,40,83,192,1046,OOR,2020
Tariq Owens,PF,24,3,15,1,5,0.2,0,2,0.0,1,3,0.333,0.2,2,2,1.0,2,1,3,0,1,0,0,1,4,OOR,2020
Jeremy Pargo,PG,33,3,44,11,22,0.5,3,7,0.429,8,15,0.533,0.568,0,1,0.0,1,2,3,8,1,0,4,8,25,OOR,2020
Jabari Parker,PF,24,38,917,219,429,0.51,32,119,0.269,187,310,0.603,0.548,61,81,0.753,61,153,214,68,45,16,64,99,531,OOR,2020
Chandler Parsons,PF,31,5,54,5,18,0.278,4,14,0.286,1,4,0.25,0.389,0,0,0.0,1,6,7,3,4,1,3,3,14,OOR,2020
Eric Paschall,PF,23,60,1654,318,640,0.497,37,129,0.287,281,511,0.55,0.526,164,212,0.774,82,193,275,127,32,13,94,125,837,OOR,2020
Anžejs Pasečņiks,C,24,27,437,61,116,0.526,0,3,0.0,61,113,0.54,0.526,34,58,0.586,42,65,107,18,9,12,24,75,156,OOR,2020
Patrick Patterson,PF,30,59,776,95,233,0.408,67,172,0.39,28,61,0.459,0.552,35,43,0.814,35,116,151,41,7,3,21,54,292,OOR,2020
Justin Patton,C,22,5,24,4,10,0.4,1,4,0.25,3,6,0.5,0.45,0,0,0.0,1,4,5,2,0,0,2,4,9,OOR,2020
Chris Paul,PG,34,70,2208,434,887,0.489,111,304,0.365,323,583,0.554,0.552,253,279,0.907,26,323,349,472,111,11,161,158,1232,OOR,2020
Cameron Payne,SG,25,8,183,33,68,0.485,15,29,0.517,18,39,0.462,0.596,6,7,0.857,4,27,31,24,8,2,11,20,87,OOR,2020
Elfrid Payton,PG,25,45,1246,193,440,0.439,14,69,0.203,179,371,0.482,0.455,49,86,0.57,52,160,212,323,70,17,96,89,449,OOR,2020
Gary Payton II,SF,27,29,432,48,116,0.414,13,46,0.283,35,70,0.5,0.47,4,8,0.5,26,54,80,48,33,7,20,54,113,OOR,2020
Norvel Pelle,C,26,24,232,25,48,0.521,0,1,0.0,25,47,0.532,0.521,7,14,0.5,20,52,72,8,3,31,18,55,57,OOR,2020
Theo Pinson,SG,24,33,365,45,155,0.29,15,80,0.188,30,75,0.4,0.339,15,16,0.938,10,44,54,56,17,4,33,35,120,OOR,2020
Mason Plumlee,C,29,61,1057,177,288,0.615,0,5,0.0,177,283,0.625,0.615,83,155,0.535,98,219,317,154,33,38,82,143,437,OOR,2020
Jakob Poeltl,C,24,66,1171,166,266,0.624,0,0,0.0,166,266,0.624,0.624,40,86,0.465,131,244,375,116,37,95,54,126,372,OOR,2020
Vincent Poirier,C,26,22,130,17,36,0.472,1,2,0.5,16,34,0.471,0.486,6,7,0.857,13,30,43,8,2,9,8,25,41,OOR,2020
Shamorie Ponds,PG,21,4,11,3,5,0.6,1,2,0.5,2,3,0.667,0.7,2,2,1.0,0,1,1,2,0,1,0,2,9,OOR,2020
Jordan Poole,SG,20,57,1274,167,502,0.333,74,265,0.279,93,237,0.392,0.406,95,119,0.798,9,109,118,134,35,10,74,94,503,OOR,2020
Kevin Porter Jr.,SF,19,50,1162,186,421,0.442,53,158,0.335,133,263,0.506,0.505,73,101,0.723,22,140,162,109,46,14,93,135,498,OOR,2020
Michael Porter Jr.,SF,21,55,903,195,383,0.509,62,147,0.422,133,236,0.564,0.59,60,72,0.833,66,193,259,46,27,25,49,100,512,OOR,2020
Otto Porter,SF,26,14,331,62,140,0.443,24,62,0.387,38,78,0.487,0.529,19,27,0.704,13,35,48,25,15,6,11,31,167,OOR,2020
Bobby Portis,PF,24,66,1393,265,589,0.45,67,187,0.358,198,402,0.493,0.507,71,93,0.763,80,258,338,98,32,18,73,110,668,OOR,2020
Kristaps Porziņģis,C,24,57,1814,398,932,0.427,142,403,0.352,256,529,0.484,0.503,226,283,0.799,100,440,540,102,41,115,92,185,1164,OOR,2020
Dwight Powell,C,28,40,1061,146,229,0.638,10,39,0.256,136,190,0.716,0.659,74,111,0.667,75,152,227,59,34,22,36,102,376,OOR,2020
Norman Powell,SG,26,52,1479,296,598,0.495,109,273,0.399,187,325,0.575,0.586,129,153,0.843,26,164,190,91,60,21,77,108,830,OOR,2020
Taurean Prince,PF,25,64,1857,278,739,0.376,146,431,0.339,132,308,0.429,0.475,71,89,0.798,50,331,381,116,57,25,127,159,773,OOR,2020
Chasson Randle,PG,26,3,40,0,4,0.0,0,2,0.0,0,2,0.0,0.0,5,6,0.833,0,2,2,5,2,0,0,3,5,OOR,2020
Julius Randle,PF,25,64,2080,463,1006,0.46,64,231,0.277,399,775,0.515,0.492,258,352,0.733,151,471,622,198,51,22,193,178,1248,OOR,2020
Josh Reaves,SF,22,4,28,3,9,0.333,0,2,0.0,3,7,0.429,0.333,2,2,1.0,1,2,3,3,0,0,0,5,8,OOR,2020
Cam Reddish,SF,20,58,1551,213,554,0.384,83,250,0.332,130,304,0.428,0.459,101,126,0.802,35,181,216,87,62,28,96,132,610,OOR,2020
J.J. Redick,SG,35,60,1581,286,631,0.453,180,397,0.453,106,234,0.453,0.596,165,185,0.892,10,141,151,119,20,10,75,96,917,OOR,2020
Naz Reid,C,20,30,495,100,243,0.412,32,97,0.33,68,146,0.466,0.477,37,53,0.698,34,90,124,35,19,22,22,83,269,OOR,2020
Josh Richardson,SG,26,55,1693,278,646,0.43,85,249,0.341,193,397,0.486,0.496,114,141,0.809,41,133,174,162,52,36,104,136,755,OOR,2020
Austin Rivers,SG,27,68,1594,211,501,0.421,96,270,0.356,115,231,0.498,0.517,78,111,0.703,27,148,175,113,49,10,50,129,596,OOR,2020
Andre Roberson,SF,28,7,87,8,29,0.276,3,14,0.214,5,15,0.333,0.328,1,2,0.5,7,20,27,4,1,3,2,13,20,OOR,2020
Duncan Robinson,SG,25,73,2166,323,687,0.47,270,606,0.446,53,81,0.654,0.667,67,72,0.931,10,222,232,102,35,19,70,193,983,OOR,2020
Glenn Robinson III,SF,26,62,1786,288,592,0.486,77,197,0.391,211,395,0.534,0.552,74,86,0.86,81,189,270,96,54,16,55,100,727,OOR,2020
Jerome Robinson,SG,22,63,979,115,310,0.371,49,153,0.32,66,157,0.42,0.45,40,57,0.702,13,116,129,87,28,17,49,112,319,OOR,2020
Justin Robinson,PG,22,9,49,5,12,0.417,3,5,0.6,2,7,0.286,0.542,0,0,0.0,1,4,5,7,0,1,3,2,13,OOR,2020
Mitchell Robinson,C,21,61,1412,253,341,0.742,0,0,0.0,253,341,0.742,0.742,84,148,0.568,186,242,428,36,52,119,37,194,590,OOR,2020
Isaiah Roby,PF,21,3,11,0,1,0.0,0,0,0.0,0,1,0.0,0.0,0,0,0.0,0,2,2,0,0,0,1,1,0,OOR,2020
Rajon Rondo,PG,33,48,984,137,328,0.418,41,125,0.328,96,203,0.473,0.48,27,41,0.659,23,119,142,240,40,2,91,58,342,OOR,2020
Derrick Rose,PG,31,50,1298,369,753,0.49,45,147,0.306,324,606,0.535,0.52,121,139,0.871,27,94,121,278,40,16,126,49,904,OOR,2020
Terrence Ross,SG,28,69,1889,341,846,0.403,177,504,0.351,164,342,0.48,0.508,157,184,0.853,13,209,222,82,77,24,70,109,1016,OOR,2020
Terry Rozier,PG,25,63,2164,398,941,0.423,172,423,0.407,226,518,0.436,0.514,166,190,0.874,50,226,276,259,61,10,141,126,1134,OOR,2020
Ricky Rubio,PG,29,65,2016,287,692,0.415,78,216,0.361,209,476,0.439,0.471,195,226,0.863,46,258,304,570,94,11,173,167,847,OOR,2020
D'Angelo Russell,PG,23,45,1452,360,846,0.426,158,431,0.367,202,415,0.487,0.519,161,199,0.809,17,160,177,285,48,13,147,86,1039,OOR,2020
Domantas Sabonis,PF,23,62,2159,458,848,0.54,17,67,0.254,441,781,0.565,0.55,214,296,0.723,189,582,771,310,47,30,170,195,1147,OOR,2020
Luka Šamanić,PF,20,3,48,5,16,0.313,3,8,0.375,2,8,0.25,0.406,3,4,0.75,1,9,10,6,0,2,2,6,16,OOR,2020
JaKarr Sampson,PF,26,34,471,68,115,0.591,2,13,0.154,66,102,0.647,0.6,18,27,0.667,20,68,88,21,16,12,15,64,156,OOR,2020
Dario Šarić,PF,25,66,1632,256,538,0.476,84,235,0.357,172,303,0.568,0.554,108,128,0.844,100,306,406,123,37,16,88,156,704,OOR,2020
Tomáš Satoranský,SG,28,65,1878,237,551,0.43,64,199,0.322,173,352,0.491,0.488,106,121,0.876,76,178,254,354,80,7,130,135,644,OOR,2020
Admiral Schofield,PF,22,33,368,35,92,0.38,19,61,0.311,16,31,0.516,0.484,10,15,0.667,7,40,47,15,8,4,7,50,99,OOR,2020
Dennis Schröder,PG,26,65,1999,453,965,0.469,125,325,0.385,328,640,0.513,0.534,198,236,0.839,19,217,236,262,45,14,166,146,1229,OOR,2020
Mike Scott,PF,31,68,1207,149,350,0.426,80,217,0.369,69,133,0.519,0.54,30,37,0.811,65,183,248,56,21,5,26,96,408,OOR,2020
Thabo Sefolosha,PF,35,41,436,37,91,0.407,15,54,0.278,22,37,0.595,0.489,3,8,0.375,21,72,93,25,24,12,15,43,92,OOR,2020
Collin Sexton,PG,21,65,2143,513,1086,0.472,97,255,0.38,416,831,0.501,0.517,226,267,0.846,61,143,204,192,65,7,158,142,1349,OOR,2020
Landry Shamet,SG,22,53,1452,158,391,0.404,111,296,0.375,47,95,0.495,0.546,65,76,0.855,6,94,100,99,20,10,42,142,492,OOR,2020
Marial Shayok,SG,24,4,28,3,12,0.25,2,6,0.333,1,6,0.167,0.333,3,4,0.75,1,6,7,1,0,1,3,4,11,OOR,2020
Iman Shumpert,SF,29,13,241,21,64,0.328,8,33,0.242,13,31,0.419,0.391,4,7,0.571,9,25,34,12,12,2,10,21,54,OOR,2020
Pascal Siakam,PF,25,60,2110,500,1104,0.453,131,365,0.359,369,739,0.499,0.512,240,303,0.792,64,375,439,207,61,53,148,170,1371,OOR,2020
Chris Silva,PF,23,44,346,48,78,0.615,0,3,0.0,48,75,0.64,0.615,37,55,0.673,60,66,126,23,9,21,32,85,133,OOR,2020
Ben Simmons,PG,23,57,2017,375,647,0.58,2,7,0.286,373,640,0.583,0.581,185,298,0.621,113,331,444,455,119,33,200,186,937,OOR,2020
Anfernee Simons,SG,20,70,1449,214,536,0.399,75,226,0.332,139,310,0.448,0.469,76,92,0.826,25,127,152,97,26,10,61,135,579,OOR,2020
Alen Smailagić,C,19,14,139,20,40,0.5,3,13,0.231,17,27,0.63,0.538,16,19,0.842,10,17,27,13,3,4,11,14,59,OOR,2020
Marcus Smart,SG,25,60,1919,256,682,0.375,137,395,0.347,119,287,0.415,0.476,127,152,0.836,42,183,225,291,101,29,103,162,776,OOR,2020
Dennis Smith Jr.,PG,22,34,537,72,211,0.341,16,54,0.296,56,157,0.357,0.379,27,53,0.509,21,57,78,98,28,8,58,65,187,OOR,2020
Ish Smith,PG,31,68,1787,308,689,0.447,62,169,0.367,246,520,0.473,0.492,62,86,0.721,30,189,219,334,59,30,95,106,740,OOR,2020
J.R. Smith,SG,34,6,79,7,22,0.318,1,11,0.091,6,11,0.545,0.341,2,2,1.0,0,5,5,3,1,0,4,5,17,OOR,2020
Zhaire Smith,SF,20,7,32,3,11,0.273,0,3,0.0,3,8,0.375,0.273,2,4,0.5,0,2,2,2,3,0,2,4,8,OOR,2020
Tony Snell,SF,28,59,1641,170,382,0.445,102,254,0.402,68,128,0.531,0.579,32,32,1.0,9,102,111,127,32,15,31,101,474,OOR,2020
Omari Spellman,C,22,49,886,127,295,0.431,43,110,0.391,84,185,0.454,0.503,73,92,0.793,77,142,219,47,33,24,54,63,370,OOR,2020
Max Strus,SF,23,2,6,2,3,0.667,0,1,0.0,2,2,1.0,0.667,1,1,1.0,1,0,1,0,0,0,0,1,5,OOR,2020
Edmond Sumner,SG,24,31,447,61,142,0.43,14,53,0.264,47,89,0.528,0.479,16,29,0.552,11,35,46,55,15,9,22,44,152,OOR,2020
Caleb Swanigan,PF-C,22,27,288,28,47,0.596,0,2,0.0,28,45,0.622,0.596,9,17,0.529,27,73,100,31,3,7,37,62,65,OOR,2020
Jayson Tatum,PF,21,66,2265,552,1226,0.45,189,469,0.403,363,757,0.48,0.527,254,313,0.812,64,396,460,200,93,57,155,136,1547,OOR,2020
Jeff Teague,PG,31,59,1464,213,489,0.436,43,117,0.368,170,372,0.457,0.48,172,197,0.873,27,115,142,308,44,19,116,106,641,OOR,2020
Garrett Temple,SG,33,62,1730,222,587,0.378,127,386,0.329,95,201,0.473,0.486,70,87,0.805,29,189,218,156,49,29,62,108,641,OOR,2020
Daniel Theis,C,27,65,1566,241,426,0.566,32,96,0.333,209,330,0.633,0.603,87,114,0.763,140,286,426,111,37,84,54,219,601,OOR,2020
Isaiah Thomas,PG,30,40,925,174,426,0.408,78,189,0.413,96,237,0.405,0.5,62,76,0.816,11,57,68,146,13,6,77,77,488,OOR,2020
Khyri Thomas,SG,23,8,61,5,17,0.294,5,14,0.357,0,3,0.0,0.441,2,4,0.5,1,0,1,3,3,0,3,9,17,OOR,2020
Lance Thomas,PF,31,7,98,8,23,0.348,4,13,0.308,4,10,0.4,0.435,4,4,1.0,2,11,13,6,0,0,6,11,24,OOR,2020
Matt Thomas,SG,25,41,440,73,150,0.487,47,99,0.475,26,51,0.51,0.643,9,12,0.75,9,52,61,22,10,1,16,38,202,OOR,2020
Tristan Thompson,PF,28,57,1721,288,562,0.512,9,23,0.391,279,539,0.518,0.52,99,161,0.615,226,351,577,120,33,50,103,124,684,OOR,2020
Sindarius Thornwell,SF,25,2,35,6,11,0.545,2,4,0.5,4,7,0.571,0.636,2,4,0.5,0,4,4,4,1,1,2,2,16,OOR,2020
Matisse Thybulle,SG,22,65,1287,112,265,0.423,56,157,0.357,56,108,0.519,0.528,25,41,0.61,44,63,107,79,94,47,51,141,305,OOR,2020
Anthony Tolliver,PF,34,55,872,65,182,0.357,49,145,0.338,16,37,0.432,0.492,21,29,0.724,34,120,154,42,19,11,34,74,200,OOR,2020
Juan Toscano-Anderson,SG,26,13,272,29,63,0.46,8,23,0.348,21,40,0.525,0.524,3,5,0.6,9,43,52,26,13,5,16,30,69,OOR,2020
Karl-Anthony Towns,C,24,35,1187,316,622,0.508,114,277,0.412,202,345,0.586,0.6,180,226,0.796,95,283,378,153,33,42,110,117,926,OOR,2020
Gary Trent Jr.,SF,21,61,1332,196,441,0.444,112,268,0.418,84,173,0.486,0.571,37,45,0.822,25,75,100,61,48,16,21,90,541,OOR,2020
Allonzo Trier,SG,24,24,291,51,106,0.481,19,53,0.358,32,53,0.604,0.571,34,43,0.791,6,23,29,28,3,4,22,29,155,OOR,2020
P.J. Tucker,PF,34,72,2467,177,426,0.415,107,299,0.358,70,127,0.551,0.541,39,48,0.813,112,364,476,115,77,36,72,229,500,OOR,2020
Rayjon Tucker,SG,22,20,161,20,43,0.465,3,17,0.176,17,26,0.654,0.5,19,23,0.826,3,17,20,5,1,1,8,10,62,OOR,2020
Evan Turner,SG,31,19,251,25,67,0.373,0,5,0.0,25,62,0.403,0.373,12,14,0.857,8,30,38,38,9,8,26,20,62,OOR,2020
Myles Turner,C,23,62,1826,268,587,0.457,86,250,0.344,182,337,0.54,0.53,127,169,0.751,86,321,407,72,46,132,85,166,749,OOR,2020
Jarrod Uthoff,PF,26,7,53,7,18,0.389,3,9,0.333,4,9,0.444,0.472,2,2,1.0,2,4,6,0,1,0,0,2,19,OOR,2020
Jonas Valančiūnas,C,27,70,1845,432,739,0.585,32,91,0.352,400,648,0.617,0.606,148,200,0.74,213,575,788,131,30,76,127,185,1044,OOR,2020
Denzel Valentine,SF,26,36,488,97,237,0.409,46,137,0.336,51,100,0.51,0.506,6,8,0.75,9,65,74,43,26,6,26,51,246,OOR,2020
Jarred Vanderbilt,PF,20,11,46,5,8,0.625,0,1,0.0,5,7,0.714,0.625,2,2,1.0,3,6,9,2,3,1,7,6,12,OOR,2020
Fred VanVleet,SG,25,54,1928,319,773,0.413,146,374,0.39,173,399,0.434,0.507,168,198,0.848,18,185,203,357,100,17,121,132,952,OOR,2020
Gabe Vincent,PG,23,9,83,8,37,0.216,6,27,0.222,2,10,0.2,0.297,0,0,0.0,0,5,5,6,5,0,1,6,22,OOR,2020
Noah Vonleh,C,24,36,377,52,92,0.565,3,15,0.2,49,77,0.636,0.582,25,32,0.781,37,87,124,28,11,6,21,40,132,OOR,2020
Nikola Vučević,C,29,62,1998,493,1033,0.477,98,289,0.339,395,744,0.531,0.525,131,167,0.784,140,533,673,222,54,47,88,135,1215,OOR,2020
Dean Wade,PF,23,12,71,9,13,0.692,2,4,0.5,7,9,0.778,0.769,0,1,0.0,3,16,19,2,2,4,3,8,20,OOR,2020
Moritz Wagner,C,22,45,835,145,266,0.545,25,80,0.313,120,186,0.645,0.592,78,95,0.821,56,163,219,56,28,19,66,152,393,OOR,2020
Dion Waiters,SG,28,10,207,41,99,0.414,15,47,0.319,26,52,0.5,0.49,14,17,0.824,2,22,24,20,4,6,16,21,111,OOR,2020
Kemba Walker,PG,29,56,1742,378,889,0.425,180,473,0.381,198,416,0.476,0.526,209,242,0.864,36,181,217,268,48,28,117,91,1145,OOR,2020
Lonnie Walker,SG,21,61,988,152,357,0.426,41,101,0.406,111,256,0.434,0.483,44,61,0.721,23,116,139,68,32,14,44,78,389,OOR,2020
Tyrone Wallace,SG,25,14,160,14,44,0.318,1,15,0.067,13,29,0.448,0.33,11,17,0.647,3,19,22,13,7,1,10,19,40,OOR,2020
Derrick Walton,PG,24,26,248,18,39,0.462,10,24,0.417,8,15,0.533,0.59,7,9,0.778,2,14,16,27,7,0,5,21,53,OOR,2020
Brad Wanamaker,PG,30,71,1369,162,362,0.448,37,102,0.363,125,260,0.481,0.499,126,136,0.926,22,122,144,179,61,14,76,133,487,OOR,2020
T.J. Warren,SF,26,67,2202,534,997,0.536,91,226,0.403,443,771,0.575,0.581,167,204,0.819,68,212,280,99,78,34,84,187,1326,OOR,2020
P.J. Washington,PF,21,58,1759,268,589,0.455,86,230,0.374,182,359,0.507,0.528,88,136,0.647,58,258,316,123,51,44,93,158,710,OOR,2020
Yuta Watanabe,SF,25,18,105,15,34,0.441,3,8,0.375,12,26,0.462,0.485,3,8,0.375,7,13,20,5,5,1,2,9,36,OOR,2020
Tremont Waters,PG,22,11,119,14,49,0.286,4,24,0.167,10,25,0.4,0.327,8,8,1.0,0,12,12,16,10,2,15,13,40,OOR,2020
Paul Watson,SF,25,10,87,10,26,0.385,4,12,0.333,6,14,0.429,0.462,7,9,0.778,2,15,17,8,4,1,3,5,31,OOR,2020
Quinndary Weatherspoon,SG,23,11,78,5,17,0.294,1,5,0.2,4,12,0.333,0.324,1,2,0.5,1,6,7,11,3,1,5,8,12,OOR,2020
Russell Westbrook,PG,31,57,2049,604,1281,0.472,55,213,0.258,549,1068,0.514,0.493,290,380,0.763,100,351,451,401,93,20,255,200,1553,OOR,2020
Coby White,PG,19,65,1674,312,792,0.394,133,376,0.354,179,416,0.43,0.478,102,129,0.791,28,202,230,175,49,6,109,117,859,OOR,2020
Derrick White,SG,25,68,1677,253,552,0.458,79,216,0.366,174,336,0.518,0.53,180,211,0.853,35,188,223,241,44,59,89,152,765,OOR,2020
Hassan Whiteside,C,30,67,2008,436,702,0.621,4,7,0.571,432,695,0.622,0.624,164,239,0.686,258,647,905,78,26,196,120,196,1040,OOR,2020
Andrew Wiggins,SF,24,54,1858,437,978,0.447,111,334,0.332,326,644,0.506,0.504,190,268,0.709,66,208,274,198,45,53,132,127,1175,OOR,2020
Grant Williams,PF,21,69,1043,87,211,0.412,24,96,0.25,63,115,0.548,0.469,39,54,0.722,59,119,178,68,30,36,50,163,237,OOR,2020
Johnathan Williams,PF,24,15,180,19,34,0.559,0,2,0.0,19,32,0.594,0.559,7,13,0.538,24,40,64,8,1,8,5,16,45,OOR,2020
Kenrich Williams,PF,25,39,832,51,147,0.347,25,97,0.258,26,50,0.52,0.432,9,26,0.346,51,135,186,57,27,21,22,88,136,OOR,2020
Lou Williams,PG,33,65,1864,391,936,0.418,111,315,0.352,280,621,0.451,0.477,292,339,0.861,31,170,201,365,43,12,182,80,1185,OOR,2020
Marvin Williams,PF,33,58,1129,119,267,0.446,56,156,0.359,63,111,0.568,0.551,49,57,0.86,30,153,183,60,36,30,33,103,343,OOR,2020
Robert Williams,C,22,29,388,64,88,0.727,0,0,0.0,64,88,0.727,0.727,22,34,0.647,40,88,128,27,22,35,21,51,150,OOR,2020
Nigel Williams-Goss,PG,25,10,50,5,16,0.313,2,7,0.286,3,9,0.333,0.375,2,2,1.0,2,4,6,6,3,1,3,6,14,OOR,2020
Zion Williamson,PF,19,24,668,210,360,0.583,6,14,0.429,204,346,0.59,0.592,114,178,0.64,64,86,150,50,16,9,59,42,540,OOR,2020
D.J. Wilson,PF,23,37,363,52,132,0.394,18,73,0.247,34,59,0.576,0.462,11,18,0.611,12,80,92,25,3,5,19,33,133,OOR,2020
Justise Winslow,SG,23,11,352,50,129,0.388,6,27,0.222,44,102,0.431,0.411,18,27,0.667,16,57,73,44,7,5,24,38,124,OOR,2020
Christian Wood,PF,24,62,1325,288,508,0.567,54,140,0.386,234,368,0.636,0.62,180,242,0.744,104,286,390,60,34,54,84,98,810,OOR,2020
Delon Wright,PG,27,73,1570,190,411,0.462,47,127,0.37,143,284,0.504,0.519,77,100,0.77,70,210,280,244,85,22,73,93,504,OOR,2020
Justin Wright-Foreman,PG,22,4,45,7,20,0.35,2,10,0.2,5,10,0.5,0.4,3,4,0.75,0,5,5,7,2,0,3,5,19,OOR,2020
Thaddeus Young,PF,31,64,1591,269,601,0.448,79,222,0.356,190,379,0.501,0.513,42,72,0.583,94,221,315,117,92,23,102,134,659,OOR,2020
Trae Young,PG,21,60,2120,546,1249,0.437,205,568,0.361,341,681,0.501,0.519,481,559,0.86,32,223,255,560,65,8,289,104,1778,OOR,2020
Cody Zeller,C,27,58,1341,251,479,0.524,18,75,0.24,233,404,0.577,0.543,122,179,0.682,160,251,411,88,40,25,75,140,642,OOR,2020
Tyler Zeller,C,30,2,4,1,4,0.25,0,0,0.0,1,4,0.25,0.25,0,0,0.0,3,1,4,0,0,0,0,0,2,OOR,2020
Ante Žižić,C,23,22,221,41,72,0.569,0,0,0.0,41,72,0.569,0.569,14,19,0.737,18,48,66,6,7,5,10,27,96,OOR,2020
Ivica Zubac,C,22,72,1326,236,385,0.613,0,2,0.0,236,383,0.616,0.613,124,166,0.747,197,346,543,82,16,66,61,168,596,OOR,2020
